,Date,HomeTeam,AwayTeam,FTHG,FTAG,FTR,HomeTeamScored,AwayTeamScored,HomeTeamConceded,AwayTeamConceded,HomeTeamPoints,AwayTeamPoints,HM1,AM1,HM2,AM2,HM3,AM3,HomeGoalDiff,AwayGoalDiff,DiffInGoals,DiffPts,MW
0,2016-08-26,Bayern Munich,Werder Bremen,6,0,H,0,0,0,0,0,0,M,M,M,M,M,M,0,0,0,0,1
1,2016-08-27,Augsburg,Wolfsburg,0,2,A,0,0,0,0,0,0,M,M,M,M,M,M,0,0,0,0,1
2,2016-08-27,Dortmund,Mainz,2,1,H,0,0,0,0,0,0,M,M,M,M,M,M,0,0,0,0,1
3,2016-08-27,Ein Frankfurt,Schalke 04,1,0,H,0,0,0,0,0,0,M,M,M,M,M,M,0,0,0,0,1
4,2016-08-27,FC Koln,Darmstadt,2,0,H,0,0,0,0,0,0,M,M,M,M,M,M,0,0,0,0,1
5,2016-08-27,Hamburg,Ingolstadt,1,1,D,0,0,0,0,0,0,M,M,M,M,M,M,0,0,0,0,1
6,2016-08-27,M'gladbach,Leverkusen,2,1,H,0,0,0,0,0,0,M,M,M,M,M,M,0,0,0,0,1
7,2016-08-28,Hertha,Freiburg,2,1,H,0,0,0,0,0,0,M,M,M,M,M,M,0,0,0,0,1
8,2016-08-28,Hoffenheim,RB Leipzig,2,2,D,0,0,0,0,0,0,M,M,M,M,M,M,0,0,0,0,1
9,2016-09-09,Schalke 04,Bayern Munich,0,2,A,0,6,1,0,0,3,M,M,M,M,M,M,-1,6,-7,-3,2
10,2016-09-10,Darmstadt,Ein Frankfurt,1,0,H,0,1,2,0,0,3,M,M,M,M,M,M,-2,1,-3,-3,2
11,2016-09-10,Freiburg,M'gladbach,3,1,H,1,2,2,1,0,3,M,M,M,M,M,M,-1,1,-2,-3,2
12,2016-09-10,Ingolstadt,Hertha,0,2,A,1,2,1,1,1,3,M,M,M,M,M,M,0,1,-1,-2,2
13,2016-09-10,Leverkusen,Hamburg,3,1,H,1,1,2,1,0,1,M,M,M,M,M,M,-1,0,-1,-1,2
14,2016-09-10,RB Leipzig,Dortmund,1,0,H,2,2,2,1,1,3,M,M,M,M,M,M,0,1,-1,-2,2
15,2016-09-10,Wolfsburg,FC Koln,0,0,D,2,2,0,0,3,3,M,M,M,M,M,M,2,2,0,0,2
16,2016-09-11,Mainz,Hoffenheim,4,4,D,1,2,2,2,0,1,M,M,M,M,M,M,-1,0,-1,-1,2
17,2016-09-11,Werder Bremen,Augsburg,1,2,A,0,0,6,2,0,0,M,M,M,M,M,M,-6,-2,-4,0,2
18,2016-09-16,FC Koln,Freiburg,3,0,H,5,1,0,5,6,0,D,W,M,M,M,M,5,-4,9,6,3
19,2016-09-17,Bayern Munich,Ingolstadt,3,1,H,9,2,1,4,6,1,W,L,M,M,M,M,8,-2,10,5,3
20,2016-09-17,Dortmund,Darmstadt,6,0,H,8,0,1,8,6,0,L,W,M,M,M,M,7,-8,15,6,3
21,2016-09-17,Ein Frankfurt,Leverkusen,2,1,H,3,2,1,4,6,0,L,W,M,M,M,M,2,-2,4,6,3
22,2016-09-17,Hamburg,RB Leipzig,0,4,A,1,6,5,2,1,4,L,W,M,M,M,M,-4,4,-8,-3,3
23,2016-09-17,Hoffenheim,Wolfsburg,0,0,D,2,2,2,0,2,4,D,D,M,M,M,M,0,2,-2,-2,3
24,2016-09-17,M'gladbach,Werder Bremen,4,1,H,6,1,2,10,6,0,L,L,M,M,M,M,4,-9,13,6,3
25,2016-09-18,Augsburg,Mainz,1,3,A,1,4,5,3,0,3,W,D,M,M,M,M,-4,1,-5,-3,3
26,2016-09-18,Hertha,Schalke 04,2,0,H,4,0,1,3,6,0,W,L,M,M,M,M,3,-3,6,6,3
27,2016-09-20,Darmstadt,Hoffenheim,1,1,D,1,3,9,3,1,3,L,D,W,D,M,M,-8,0,-8,-2,4
28,2016-09-20,Freiburg,Hamburg,1,0,H,2,1,5,6,3,1,L,L,W,L,M,M,-3,-5,2,2,4
29,2016-09-20,Ingolstadt,Ein Frankfurt,0,2,A,2,5,6,1,1,9,L,W,L,L,M,M,-4,4,-8,-8,4
30,2016-09-20,Wolfsburg,Dortmund,1,5,A,3,13,5,2,4,9,D,W,D,L,M,M,-2,11,-13,-5,4
31,2016-09-21,Bayern Munich,Hertha,3,0,H,12,4,1,4,9,6,W,W,W,W,M,M,11,0,11,3,4
32,2016-09-21,Leverkusen,Augsburg,0,0,D,2,1,4,5,1,1,L,L,W,W,M,M,-2,-4,2,0,4
33,2016-09-21,RB Leipzig,M'gladbach,1,1,D,7,7,3,3,5,7,W,W,W,L,M,M,4,4,0,-2,4
34,2016-09-21,Schalke 04,FC Koln,1,3,A,1,8,6,1,0,9,L,W,L,D,M,M,-5,7,-12,-9,4
35,2016-09-21,Werder Bremen,Mainz,1,2,A,2,6,12,4,0,6,L,W,L,D,M,M,-10,2,-12,-6,4
36,2016-09-23,Dortmund,Freiburg,3,1,H,16,3,3,8,12,3,W,W,W,L,L,W,13,-5,18,9,5
37,2016-09-24,Augsburg,Darmstadt,1,0,H,2,1,5,10,4,1,D,D,L,L,W,W,-3,-9,6,3,5
38,2016-09-24,Ein Frankfurt,Hertha,3,3,D,8,7,4,7,10,7,W,L,W,W,L,W,4,0,4,3,5
39,2016-09-24,Hamburg,Bayern Munich,0,1,A,1,13,7,1,1,12,L,W,L,W,L,W,-6,12,-18,-11,5
40,2016-09-24,Mainz,Leverkusen,2,3,A,8,5,7,6,6,4,W,D,W,L,D,W,1,-1,2,2,5
41,2016-09-24,M'gladbach,Ingolstadt,2,0,H,9,2,3,8,10,1,D,L,W,L,L,L,6,-6,12,9,5
42,2016-09-24,Werder Bremen,Wolfsburg,2,1,H,4,4,13,7,3,4,L,L,L,D,L,D,-9,-3,-6,-1,5
43,2016-09-25,FC Koln,RB Leipzig,1,1,D,9,8,2,4,10,6,W,D,W,W,D,W,7,4,3,4,5
44,2016-09-25,Hoffenheim,Schalke 04,2,1,H,5,2,4,8,6,0,D,L,D,L,D,L,1,-6,7,6,5
45,2016-09-30,RB Leipzig,Augsburg,2,1,H,10,3,5,7,9,4,D,W,D,D,W,L,5,-4,9,5,6
46,2016-10-01,Bayern Munich,FC Koln,1,1,D,14,10,2,3,13,11,W,D,W,W,W,W,12,7,5,2,6
47,2016-10-01,Darmstadt,Werder Bremen,2,2,D,3,6,12,15,2,4,L,W,D,L,L,L,-9,-9,0,-2,6
48,2016-10-01,Freiburg,Ein Frankfurt,1,0,H,4,8,8,5,6,10,L,D,W,W,L,W,-4,3,-7,-4,6
49,2016-10-01,Hertha,Hamburg,2,0,H,9,1,7,9,10,1,D,L,L,L,W,L,2,-8,10,9,6
50,2016-10-01,Ingolstadt,Hoffenheim,1,2,A,3,7,10,5,1,9,L,W,L,D,L,D,-7,2,-9,-8,6
51,2016-10-01,Leverkusen,Dortmund,2,0,H,7,16,6,5,7,12,W,W,D,W,L,W,1,11,-10,-5,6
52,2016-10-02,Schalke 04,M'gladbach,4,0,H,6,9,8,7,3,10,L,W,L,D,L,W,-2,2,-4,-7,6
53,2016-10-02,Wolfsburg,Mainz,0,0,D,4,8,7,7,5,7,L,L,L,W,D,W,-3,1,-4,-2,6
54,2016-10-14,Dortmund,Hertha,1,1,D,17,10,6,8,13,11,L,W,W,D,W,L,11,2,9,2,7
55,2016-10-15,Augsburg,Schalke 04,1,1,D,4,7,8,9,5,4,L,W,W,L,D,L,-4,-2,-2,1,7
56,2016-10-15,Ein Frankfurt,Bayern Munich,2,2,D,10,16,7,4,11,14,L,D,D,W,W,W,3,12,-9,-3,7
57,2016-10-15,FC Koln,Ingolstadt,2,1,H,12,4,4,12,14,1,D,L,D,L,W,L,8,-8,16,13,7
58,2016-10-15,Hoffenheim,Freiburg,2,1,H,9,5,6,10,12,6,W,W,W,L,D,W,3,-5,8,6,7
59,2016-10-15,M'gladbach,Hamburg,0,0,D,9,1,7,9,11,2,L,L,W,L,D,L,2,-8,10,9,7
60,2016-10-15,Werder Bremen,Leverkusen,2,1,H,8,8,16,8,7,7,D,W,W,W,L,D,-8,0,-8,0,7
61,2016-10-16,Mainz,Darmstadt,2,1,H,10,4,8,14,10,2,D,D,L,L,W,D,2,-10,12,8,7
62,2016-10-16,Wolfsburg,RB Leipzig,0,1,A,4,11,8,5,5,12,D,W,L,D,L,D,-4,6,-10,-7,7
63,2016-10-21,Hamburg,Ein Frankfurt,0,3,A,1,13,12,7,2,14,D,D,L,L,L,D,-11,6,-17,-12,8
64,2016-10-22,Bayern Munich,M'gladbach,2,0,H,18,9,4,9,17,11,D,D,D,L,W,W,14,0,14,6,8
65,2016-10-22,Darmstadt,Wolfsburg,3,1,H,7,5,15,11,5,5,L,L,D,D,L,L,-8,-6,-2,0,8
66,2016-10-22,Freiburg,Augsburg,2,1,H,7,5,11,10,9,5,L,D,W,L,L,W,-4,-5,1,4,8
67,2016-10-22,Hertha,FC Koln,2,1,H,12,13,9,6,14,14,D,W,W,D,D,D,3,7,-4,0,8
68,2016-10-22,Ingolstadt,Dortmund,3,3,D,7,20,15,9,2,14,L,D,L,L,L,W,-8,11,-19,-12,8
69,2016-10-22,Leverkusen,Hoffenheim,0,3,A,8,12,11,6,7,15,L,W,W,W,W,W,-3,6,-9,-8,8
70,2016-10-23,RB Leipzig,Werder Bremen,3,1,H,14,9,6,19,15,7,W,W,W,D,D,W,8,-10,18,8,8
71,2016-10-23,Schalke 04,Mainz,3,0,H,10,10,9,11,7,10,D,W,W,D,L,L,1,-1,2,-3,8
72,2016-10-28,M'gladbach,Ein Frankfurt,0,0,D,9,13,9,7,12,15,L,W,D,D,L,L,0,6,-6,-3,9
73,2016-10-29,Augsburg,Bayern Munich,1,3,A,6,21,13,5,5,20,L,W,D,D,L,D,-7,16,-23,-15,9
74,2016-10-29,Darmstadt,RB Leipzig,0,2,A,7,16,17,6,5,18,W,W,L,W,D,W,-10,10,-20,-13,9
75,2016-10-29,Dortmund,Schalke 04,0,0,D,20,10,9,9,15,8,D,W,D,D,L,W,11,1,10,7,9
76,2016-10-29,Mainz,Ingolstadt,2,0,H,12,7,11,17,13,2,L,D,W,L,D,L,1,-10,11,11,9
77,2016-10-29,Werder Bremen,Freiburg,1,3,A,10,10,22,12,7,12,L,W,W,L,D,W,-12,-2,-10,-5,9
78,2016-10-29,Wolfsburg,Leverkusen,1,2,A,6,10,13,12,5,10,L,L,L,L,D,W,-7,-2,-5,-5,9
79,2016-10-30,FC Koln,Hamburg,3,0,H,16,1,6,15,17,2,L,L,W,D,D,L,10,-14,24,15,9
80,2016-10-30,Hoffenheim,Hertha,1,0,H,13,12,6,10,18,14,W,W,W,D,W,W,7,2,5,4,9
81,2016-11-04,Hertha,M'gladbach,3,0,H,15,9,10,12,17,12,L,D,W,L,D,D,5,-3,8,5,10
82,2016-11-05,Bayern Munich,Hoffenheim,1,1,D,22,14,6,7,21,19,W,W,W,W,D,W,16,7,9,2,10
83,2016-11-05,Ein Frankfurt,FC Koln,1,0,H,14,16,7,7,18,17,D,W,W,L,D,W,7,9,-2,1,10
84,2016-11-05,Freiburg,Wolfsburg,0,3,A,10,9,15,13,12,8,W,L,W,L,L,L,-5,-4,-1,4,10
85,2016-11-05,Hamburg,Dortmund,2,5,A,3,25,20,11,2,18,L,D,L,D,D,D,-17,14,-31,-16,10
86,2016-11-05,Ingolstadt,Augsburg,0,2,A,7,8,19,13,2,8,L,L,D,L,L,D,-12,-5,-7,-6,10
87,2016-11-05,Leverkusen,Darmstadt,3,2,H,13,9,14,20,13,5,W,L,L,W,L,L,-1,-11,10,8,10
88,2016-11-06,RB Leipzig,Mainz,3,1,H,19,13,7,14,21,13,W,W,W,L,W,W,12,-1,13,8,10
89,2016-11-06,Schalke 04,Werder Bremen,3,1,H,13,11,10,25,11,7,D,L,W,L,D,W,3,-14,17,4,10
90,2016-11-18,Leverkusen,RB Leipzig,2,3,A,15,22,17,9,13,24,W,W,W,W,L,W,-2,13,-15,-11,11
91,2016-11-19,Augsburg,Hertha,0,0,D,8,15,13,10,9,18,W,W,L,L,L,W,-5,5,-10,-9,11
92,2016-11-19,Darmstadt,Ingolstadt,0,1,A,9,8,21,19,5,5,L,L,L,L,W,D,-12,-11,-1,0,11
93,2016-11-19,Dortmund,Bayern Munich,1,0,H,26,22,11,7,21,21,W,D,D,W,D,W,15,15,0,0,11
94,2016-11-19,Mainz,Freiburg,4,2,H,17,12,16,19,16,12,L,L,W,W,L,W,1,-7,8,4,11
95,2016-11-19,M'gladbach,FC Koln,1,2,A,10,18,14,8,12,20,L,L,D,W,L,L,-4,10,-14,-8,11
96,2016-11-19,Wolfsburg,Schalke 04,0,1,A,9,14,14,10,8,14,W,W,L,D,L,W,-5,4,-9,-6,11
97,2016-11-20,Hoffenheim,Hamburg,2,2,D,16,5,9,22,20,3,D,L,W,L,W,L,7,-17,24,17,11
98,2016-11-20,Werder Bremen,Ein Frankfurt,1,2,A,12,16,27,8,7,21,L,W,L,D,L,W,-15,8,-23,-14,11
99,2016-11-25,Freiburg,RB Leipzig,1,4,A,13,26,23,10,12,27,L,W,L,W,W,W,-10,16,-26,-15,12
100,2016-11-26,Bayern Munich,Leverkusen,2,1,H,24,16,8,19,24,13,L,L,D,W,W,W,16,-3,19,11,12
101,2016-11-26,Ein Frankfurt,Dortmund,2,1,H,18,27,9,13,24,21,W,W,W,W,D,D,9,14,-5,3,12
102,2016-11-26,FC Koln,Augsburg,0,0,D,18,8,8,13,21,10,W,D,L,W,W,L,10,-5,15,11,12
103,2016-11-26,Hamburg,Werder Bremen,2,2,D,7,14,24,29,4,8,D,L,L,L,L,L,-17,-15,-2,-4,12
104,2016-11-26,Ingolstadt,Wolfsburg,1,1,D,9,10,20,15,6,9,W,L,L,W,L,L,-11,-5,-6,-3,12
105,2016-11-26,M'gladbach,Hoffenheim,1,1,D,11,17,15,10,13,21,L,D,L,D,D,W,-4,7,-11,-8,12
106,2016-11-27,Hertha,Mainz,2,1,H,17,18,11,18,21,16,D,W,W,L,L,W,6,0,6,5,12
107,2016-11-27,Schalke 04,Darmstadt,3,1,H,17,10,11,24,17,5,W,L,W,L,D,L,6,-14,20,12,12
108,2016-12-02,Mainz,Bayern Munich,1,3,A,19,27,21,9,16,27,L,W,W,L,L,D,-2,18,-20,-11,13
109,2016-12-03,Dortmund,M'gladbach,4,1,H,31,12,14,19,24,13,L,D,W,L,W,L,17,-7,24,11,13
110,2016-12-03,Hoffenheim,FC Koln,4,0,H,21,18,10,12,24,21,D,D,D,W,D,L,11,6,5,3,13
111,2016-12-03,Leverkusen,Freiburg,1,1,D,17,14,20,24,14,13,L,L,L,L,W,L,-3,-10,7,1,13
112,2016-12-03,RB Leipzig,Schalke 04,2,1,H,28,18,11,13,30,17,W,W,W,W,W,W,17,5,12,13,13
113,2016-12-03,Werder Bremen,Ingolstadt,2,1,H,16,10,30,22,11,6,D,D,L,W,L,L,-14,-12,-2,5,13
114,2016-12-03,Wolfsburg,Hertha,2,3,A,12,20,18,13,9,24,D,W,L,D,W,W,-6,7,-13,-15,13
115,2016-12-04,Augsburg,Ein Frankfurt,1,1,D,9,19,14,10,11,25,D,W,D,W,W,W,-5,9,-14,-14,13
116,2016-12-04,Darmstadt,Hamburg,0,2,A,10,9,26,24,5,7,L,D,L,D,L,L,-16,-15,-1,-2,13
117,2016-12-09,Ein Frankfurt,Hoffenheim,0,0,D,19,21,10,10,26,25,D,W,W,D,W,D,9,11,-2,1,14
118,2016-12-10,Bayern Munich,Wolfsburg,5,0,H,32,12,9,23,30,9,W,L,W,D,L,L,23,-11,34,21,14
119,2016-12-10,FC Koln,Dortmund,1,1,D,19,32,13,15,22,25,L,W,D,L,W,W,6,17,-11,-3,14
120,2016-12-10,Freiburg,Darmstadt,1,0,H,15,10,24,27,16,5,D,L,L,L,L,L,-9,-17,8,11,14
121,2016-12-10,Hamburg,Augsburg,1,0,H,10,9,24,15,10,11,W,D,D,D,D,D,-14,-6,-8,-1,14
122,2016-12-10,Hertha,Werder Bremen,0,1,A,20,17,14,30,24,14,W,W,W,D,D,L,6,-13,19,10,14
123,2016-12-10,Ingolstadt,RB Leipzig,1,0,H,11,28,22,12,9,30,L,W,D,W,W,W,-11,16,-27,-21,14
124,2016-12-11,M'gladbach,Mainz,1,0,H,13,19,19,22,16,16,L,L,D,L,L,W,-6,-3,-3,0,14
125,2016-12-11,Schalke 04,Leverkusen,0,1,A,18,18,14,20,17,17,L,D,W,L,W,L,4,-2,6,0,14
126,2016-12-16,Hoffenheim,Dortmund,2,2,D,23,34,12,17,26,26,D,D,W,W,D,L,11,17,-6,0,15
127,2016-12-17,Augsburg,M'gladbach,1,0,H,10,13,15,20,14,16,L,W,D,L,D,D,-5,-7,2,-2,15
128,2016-12-17,Mainz,Hamburg,3,1,H,22,11,23,27,19,10,L,W,L,W,L,D,-1,-16,15,9,15
129,2016-12-17,RB Leipzig,Hertha,2,0,H,30,20,12,16,33,24,L,L,W,W,W,W,18,4,14,9,15
130,2016-12-17,Schalke 04,Freiburg,1,1,D,19,16,15,25,18,17,L,W,L,D,W,L,4,-9,13,1,15
131,2016-12-17,Werder Bremen,FC Koln,1,1,D,18,20,31,14,15,23,W,D,W,L,D,D,-13,6,-19,-8,15
132,2016-12-17,Wolfsburg,Ein Frankfurt,1,0,H,13,19,23,11,12,26,L,D,L,D,D,W,-10,8,-18,-14,15
133,2016-12-18,Darmstadt,Bayern Munich,0,1,A,10,33,28,9,5,33,L,W,L,W,L,W,-18,24,-42,-28,15
134,2016-12-18,Leverkusen,Ingolstadt,1,2,A,19,13,22,23,17,12,W,W,D,L,L,D,-3,-10,7,5,15
135,2016-12-20,Dortmund,Augsburg,1,1,D,35,11,18,16,27,15,D,W,D,L,W,D,17,-5,22,12,16
136,2016-12-20,Ein Frankfurt,Mainz,3,0,H,22,22,11,26,29,19,L,W,D,L,D,L,11,-4,15,10,16
137,2016-12-20,Hamburg,Schalke 04,2,1,H,13,20,28,17,13,18,L,D,W,L,W,L,-15,3,-18,-5,16
138,2016-12-20,M'gladbach,Wolfsburg,1,2,A,14,15,22,24,16,15,L,W,W,L,L,L,-8,-9,1,1,16
139,2016-12-21,Bayern Munich,RB Leipzig,3,0,H,36,30,9,15,36,33,W,W,W,L,W,W,27,15,12,3,16
140,2016-12-21,FC Koln,Leverkusen,1,1,D,21,20,15,23,24,18,D,L,D,W,L,D,6,-3,9,6,16
141,2016-12-21,Hertha,Darmstadt,2,0,H,22,10,16,30,27,5,L,L,L,L,W,L,6,-20,26,22,16
142,2016-12-21,Hoffenheim,Werder Bremen,1,1,D,24,19,13,32,27,16,D,D,D,W,W,W,11,-13,24,11,16
143,2016-12-21,Ingolstadt,Freiburg,1,2,A,14,18,25,26,12,20,W,D,W,W,L,D,-11,-8,-3,-8,16
144,2017-01-20,Freiburg,Bayern Munich,1,2,A,19,38,28,10,20,39,W,W,D,W,W,W,-9,28,-37,-19,17
145,2017-01-21,Augsburg,Hoffenheim,0,2,A,11,26,18,13,15,30,D,D,W,D,L,D,-7,13,-20,-15,17
146,2017-01-21,Darmstadt,M'gladbach,0,0,D,10,14,30,22,6,17,L,L,L,L,L,W,-20,-8,-12,-11,17
147,2017-01-21,RB Leipzig,Ein Frankfurt,3,0,H,33,22,15,14,36,29,L,W,W,L,L,D,18,8,10,7,17
148,2017-01-21,Schalke 04,Ingolstadt,1,0,H,21,14,17,26,21,12,L,L,D,W,L,W,4,-12,16,9,17
149,2017-01-21,Werder Bremen,Dortmund,1,2,A,20,37,34,19,16,30,D,D,D,D,W,D,-14,18,-32,-14,17
150,2017-01-21,Wolfsburg,Hamburg,1,0,H,16,13,24,29,18,13,W,W,W,L,L,W,-8,-16,8,5,17
151,2017-01-22,Leverkusen,Hertha,3,1,H,23,23,24,19,21,27,D,W,L,L,W,L,-1,4,-5,-6,17
152,2017-01-22,Mainz,FC Koln,0,0,D,22,21,26,15,20,25,L,D,W,D,L,D,-4,6,-10,-5,17
153,2017-01-27,Schalke 04,Ein Frankfurt,0,1,A,21,23,18,14,21,32,W,L,L,W,D,L,3,9,-6,-11,18
154,2017-01-28,Darmstadt,FC Koln,1,6,A,11,27,36,16,6,28,D,D,L,D,L,D,-25,11,-36,-22,18
155,2017-01-28,Ingolstadt,Hamburg,3,1,H,17,14,27,32,15,13,L,L,L,W,W,L,-10,-18,8,2,18
156,2017-01-28,Leverkusen,M'gladbach,2,3,A,25,17,27,24,21,20,W,D,D,L,L,L,-2,-7,5,1,18
157,2017-01-28,RB Leipzig,Hoffenheim,2,1,H,35,27,16,15,39,30,W,W,L,D,W,D,19,12,7,9,18
158,2017-01-28,Werder Bremen,Bayern Munich,1,2,A,21,40,36,11,16,42,L,W,D,W,D,W,-15,29,-44,-26,18
159,2017-01-28,Wolfsburg,Augsburg,1,2,A,17,13,26,19,18,18,W,L,W,D,W,W,-9,-6,-3,0,18
160,2017-01-29,Freiburg,Hertha,2,1,H,21,24,29,21,23,27,L,L,W,W,D,L,-8,3,-11,-4,18
161,2017-01-29,Mainz,Dortmund,1,1,D,23,38,27,20,21,31,D,W,L,D,W,D,-4,18,-22,-10,18
162,2017-02-03,Hamburg,Leverkusen,1,0,H,15,25,32,28,16,21,L,L,L,W,W,D,-17,-3,-14,-5,19
163,2017-02-04,Bayern Munich,Schalke 04,1,1,D,41,22,12,19,43,22,W,L,W,W,W,L,29,3,26,21,19
164,2017-02-04,Dortmund,RB Leipzig,1,0,H,39,35,20,17,34,39,D,W,W,W,D,L,19,18,1,-5,19
165,2017-02-04,FC Koln,Wolfsburg,1,0,H,28,17,16,27,31,18,W,L,D,W,D,W,12,-10,22,13,19
166,2017-02-04,Hertha,Ingolstadt,1,0,H,25,17,21,28,30,15,L,W,L,L,W,L,4,-11,15,15,19
167,2017-02-04,Hoffenheim,Mainz,4,0,H,31,23,15,31,33,21,L,D,W,D,D,L,16,-8,24,12,19
168,2017-02-04,M'gladbach,Freiburg,3,0,H,20,21,24,32,23,23,W,W,D,L,L,W,-4,-11,7,0,19
169,2017-02-05,Augsburg,Werder Bremen,3,2,H,16,23,21,39,21,16,W,L,L,L,D,D,-5,-16,11,5,19
170,2017-02-05,Ein Frankfurt,Darmstadt,2,0,H,25,11,14,38,35,6,W,L,L,D,W,L,11,-27,38,29,19
171,2017-02-10,Mainz,Augsburg,2,0,H,25,16,31,23,24,21,L,W,D,W,D,L,-6,-7,1,3,20
172,2017-02-11,Darmstadt,Dortmund,2,1,H,13,40,39,22,9,34,L,W,L,D,D,W,-26,18,-44,-25,20
173,2017-02-11,Ingolstadt,Bayern Munich,0,2,A,17,43,30,12,15,46,L,D,W,W,L,W,-13,31,-44,-31,20
174,2017-02-11,Leverkusen,Ein Frankfurt,3,0,H,28,25,28,17,24,35,L,W,L,W,W,L,0,8,-8,-11,20
175,2017-02-11,RB Leipzig,Hamburg,0,3,A,35,18,20,32,39,19,L,W,W,L,W,L,15,-14,29,20,20
176,2017-02-11,Schalke 04,Hertha,2,0,H,24,25,19,23,25,30,D,W,L,L,W,L,5,2,3,-5,20
177,2017-02-11,Werder Bremen,M'gladbach,0,1,A,23,21,40,24,16,26,L,W,L,W,L,D,-17,-3,-14,-10,20
178,2017-02-12,Freiburg,FC Koln,2,1,H,23,29,33,18,26,31,L,W,W,W,L,D,-10,11,-21,-5,20
179,2017-02-12,Wolfsburg,Hoffenheim,2,1,H,19,32,28,17,21,33,L,W,L,L,W,W,-9,15,-24,-12,20
180,2017-02-17,Augsburg,Leverkusen,1,3,A,17,31,26,29,21,27,L,W,W,L,W,L,-9,2,-11,-6,21
181,2017-02-18,Dortmund,Wolfsburg,3,0,H,43,19,22,31,37,21,L,W,W,L,D,L,21,-12,33,16,21
182,2017-02-18,Ein Frankfurt,Ingolstadt,0,2,A,25,19,19,30,35,18,L,L,W,L,W,W,6,-11,17,17,21
183,2017-02-18,Hamburg,Freiburg,2,2,D,20,25,34,35,20,27,W,W,W,L,L,W,-14,-10,-4,-7,21
184,2017-02-18,Hertha,Bayern Munich,1,1,D,26,44,24,13,31,47,L,W,W,D,L,W,2,31,-29,-16,21
185,2017-02-18,Hoffenheim,Darmstadt,2,0,H,34,13,17,41,36,9,L,W,W,L,L,L,17,-28,45,27,21
186,2017-02-18,Mainz,Werder Bremen,0,2,A,25,25,33,40,24,19,W,L,L,L,D,L,-8,-15,7,5,21
187,2017-02-19,FC Koln,Schalke 04,1,1,D,30,25,19,20,32,26,L,W,W,D,W,L,11,5,6,6,21
188,2017-02-19,M'gladbach,RB Leipzig,1,2,A,22,37,26,21,26,42,W,L,W,L,W,W,-4,16,-20,-16,21
189,2017-02-24,Wolfsburg,Werder Bremen,1,2,A,1,2,33,41,21,22,L,W,W,L,L,L,-32,-39,7,-1,22
190,2017-02-25,Bayern Munich,Hamburg,8,0,H,8,0,13,42,50,20,D,D,W,W,D,W,-5,-42,37,30,22
191,2017-02-25,Darmstadt,Augsburg,1,2,A,1,2,43,27,9,24,L,L,W,L,L,W,-42,-25,-17,-15,22
192,2017-02-25,Freiburg,Dortmund,0,3,A,0,3,38,22,27,40,D,W,W,L,L,W,-38,-19,-19,-13,22
193,2017-02-25,Hertha,Ein Frankfurt,2,0,H,2,0,24,21,34,35,D,L,L,L,W,W,-22,-21,-1,-1,22
194,2017-02-25,Leverkusen,Mainz,0,2,A,0,2,31,33,27,27,W,L,W,W,L,L,-31,-31,0,0,22
195,2017-02-25,RB Leipzig,FC Koln,3,1,H,3,1,22,22,45,32,W,D,L,L,L,W,-19,-21,2,13,22
196,2017-02-26,Ingolstadt,M'gladbach,0,2,A,0,2,32,26,18,29,W,L,L,W,L,W,-32,-24,-8,-11,22
197,2017-02-26,Schalke 04,Hoffenheim,1,1,D,1,1,21,18,27,37,D,W,W,L,D,W,-20,-17,-3,-10,22
198,2017-03-03,Augsburg,RB Leipzig,2,2,D,2,2,29,24,25,46,W,W,L,W,L,L,-27,-22,-5,-21,23
199,2017-03-04,Dortmund,Leverkusen,6,2,H,6,2,24,37,43,27,W,L,W,W,L,W,-18,-35,17,16,23
200,2017-03-04,FC Koln,Bayern Munich,0,3,A,0,3,25,13,32,53,L,W,D,D,L,W,-25,-10,-15,-21,23
201,2017-03-04,Hoffenheim,Ingolstadt,5,2,H,5,2,20,37,40,18,D,L,W,W,L,L,-15,-35,20,22,23
202,2017-03-04,Mainz,Wolfsburg,1,1,D,1,1,34,34,28,22,W,L,L,L,W,W,-33,-33,0,6,23
203,2017-03-04,M'gladbach,Schalke 04,4,2,H,4,2,28,25,32,27,W,D,L,D,W,W,-24,-23,-1,5,23
204,2017-03-04,Werder Bremen,Darmstadt,2,0,H,2,0,41,45,25,9,W,L,W,L,L,W,-39,-45,6,16,23
205,2017-03-05,Ein Frankfurt,Freiburg,1,2,A,1,2,23,39,35,30,L,L,L,D,L,W,-22,-37,15,5,23
206,2017-03-05,Hamburg,Hertha,1,0,H,1,0,42,25,23,34,L,W,D,D,W,L,-41,-25,-16,-11,23
207,2017-03-10,Leverkusen,Werder Bremen,1,1,D,1,1,38,42,28,26,L,W,L,W,W,W,-37,-41,4,2,24
208,2017-03-11,Bayern Munich,Ein Frankfurt,3,0,H,3,0,13,26,56,35,W,L,W,L,D,L,-10,-26,16,21,24
209,2017-03-11,Darmstadt,Mainz,2,1,H,2,1,46,36,12,28,L,D,L,W,L,L,-44,-35,-9,-16,24
210,2017-03-11,Freiburg,Hoffenheim,1,1,D,1,1,40,21,31,41,W,W,L,D,D,W,-39,-20,-19,-10,24
211,2017-03-11,Hertha,Dortmund,2,1,H,2,1,26,26,37,43,L,W,W,W,D,W,-24,-25,1,-6,24
212,2017-03-11,Ingolstadt,FC Koln,2,2,D,2,2,39,27,19,33,L,L,L,L,W,D,-37,-25,-12,-14,24
213,2017-03-11,RB Leipzig,Wolfsburg,0,1,A,0,1,25,34,46,25,D,D,W,L,W,L,-25,-33,8,21,24
214,2017-03-12,Hamburg,M'gladbach,2,1,H,2,1,43,30,26,32,W,W,L,W,D,L,-41,-29,-12,-6,24
215,2017-03-12,Schalke 04,Augsburg,3,0,H,3,0,25,32,30,25,L,D,D,W,D,L,-22,-32,10,5,24
216,2017-03-17,Dortmund,Ingolstadt,1,0,H,1,0,26,40,46,19,L,D,W,L,W,L,-25,-40,15,27,25
217,2017-03-18,Augsburg,Freiburg,1,1,D,1,1,33,41,26,32,L,D,D,W,W,L,-32,-40,8,-6,25
218,2017-03-18,Ein Frankfurt,Hamburg,0,0,D,0,0,26,43,36,27,L,W,L,W,L,L,-26,-43,17,9,25
219,2017-03-18,FC Koln,Hertha,4,2,H,4,2,29,30,36,37,D,W,L,L,L,W,-25,-28,3,-1,25
220,2017-03-18,Hoffenheim,Leverkusen,1,0,H,1,0,21,39,44,28,D,D,W,L,D,L,-20,-39,19,16,25
221,2017-03-18,Werder Bremen,RB Leipzig,3,0,H,3,0,42,28,29,46,D,L,W,D,W,W,-39,-28,-11,-17,25
222,2017-03-18,Wolfsburg,Darmstadt,1,0,H,1,0,34,47,28,12,W,W,D,L,L,L,-33,-47,14,16,25
223,2017-03-19,Mainz,Schalke 04,0,1,A,0,1,37,25,28,33,L,W,D,L,W,D,-37,-24,-13,-5,25
224,2017-03-19,M'gladbach,Bayern Munich,0,1,A,0,1,31,13,32,59,L,W,W,W,W,W,-31,-12,-19,-27,25
225,2017-03-31,Hertha,Hoffenheim,1,3,A,1,3,33,22,37,47,L,W,W,D,L,W,-32,-19,-13,-10,26
226,2017-04-01,Bayern Munich,Augsburg,6,0,H,6,0,13,39,62,26,W,D,W,L,W,D,-7,-39,32,36,26
227,2017-04-01,Ein Frankfurt,M'gladbach,0,0,D,0,0,26,31,37,33,D,L,L,L,L,W,-26,-31,5,4,26
228,2017-04-01,Freiburg,Werder Bremen,2,5,A,2,5,46,44,32,32,D,W,D,D,W,W,-44,-39,-5,0,26
229,2017-04-01,Hamburg,FC Koln,2,1,H,2,1,44,31,30,36,D,W,W,D,W,L,-42,-30,-12,-6,26
230,2017-04-01,RB Leipzig,Darmstadt,4,0,H,4,0,28,51,49,12,L,L,L,W,D,L,-24,-51,27,37,26
231,2017-04-01,Schalke 04,Dortmund,1,1,D,1,1,26,27,34,47,W,W,W,L,L,W,-25,-26,1,-13,26
232,2017-04-02,Ingolstadt,Mainz,2,1,H,2,1,41,39,22,28,L,L,D,L,L,D,-39,-38,-1,-6,26
233,2017-04-02,Leverkusen,Wolfsburg,3,3,D,3,3,42,37,29,29,L,W,D,W,L,D,-39,-34,-5,0,26
234,2017-04-04,Dortmund,Hamburg,3,0,H,3,0,27,47,50,30,D,W,W,D,L,W,-24,-47,23,20,27
235,2017-04-04,FC Koln,Ein Frankfurt,1,0,H,1,0,31,27,39,37,L,D,W,D,D,L,-30,-27,-3,2,27
236,2017-04-04,Hoffenheim,Bayern Munich,1,0,H,1,0,22,14,50,62,W,W,W,W,D,W,-21,-14,-7,-12,27
237,2017-04-04,Werder Bremen,Schalke 04,3,0,H,3,0,44,29,35,34,W,D,W,W,D,W,-41,-29,-12,1,27
238,2017-04-05,Augsburg,Ingolstadt,2,3,A,2,3,42,43,26,25,L,W,D,L,L,D,-40,-40,0,1,27
239,2017-04-05,Darmstadt,Leverkusen,0,2,A,0,2,53,42,12,32,L,D,L,L,W,D,-53,-40,-13,-20,27
240,2017-04-05,Mainz,RB Leipzig,2,3,A,2,3,42,30,28,52,L,W,L,L,L,L,-40,-27,-13,-24,27
241,2017-04-05,M'gladbach,Hertha,1,0,H,1,0,31,34,36,37,D,L,L,L,L,W,-30,-34,4,-1,27
242,2017-04-05,Wolfsburg,Freiburg,0,1,A,0,1,38,46,29,35,D,L,W,D,W,D,-38,-45,7,-6,27
243,2017-04-07,Ein Frankfurt,Werder Bremen,2,2,D,2,2,29,46,38,36,L,W,D,W,D,W,-27,-44,17,2,28
244,2017-04-08,Bayern Munich,Dortmund,4,1,H,4,1,15,31,65,50,L,W,W,D,W,W,-11,-30,19,15,28
245,2017-04-08,FC Koln,M'gladbach,2,3,A,2,3,34,33,39,39,W,W,L,D,W,L,-32,-30,-2,0,28
246,2017-04-08,Freiburg,Mainz,1,0,H,1,0,46,43,38,28,W,L,L,L,D,L,-45,-43,-2,10,28
247,2017-04-08,Hamburg,Hoffenheim,2,1,H,2,1,48,24,33,50,L,W,W,W,D,W,-46,-23,-23,-17,28
248,2017-04-08,RB Leipzig,Leverkusen,1,0,H,1,0,30,43,55,32,W,W,W,D,L,L,-29,-43,14,23,28
249,2017-04-08,Schalke 04,Wolfsburg,4,1,H,4,1,30,42,37,29,L,L,D,D,W,W,-26,-41,15,8,28
250,2017-04-09,Hertha,Augsburg,2,0,H,2,0,34,44,40,26,L,L,L,L,L,D,-32,-44,12,14,28
251,2017-04-09,Ingolstadt,Darmstadt,3,2,H,3,2,45,56,28,12,W,L,W,L,L,L,-42,-54,12,16,28
252,2017-04-15,Augsburg,FC Koln,2,1,H,2,1,45,36,29,39,L,L,L,W,L,L,-43,-35,-8,-10,29
253,2017-04-15,Dortmund,Ein Frankfurt,3,1,H,3,1,32,32,53,38,L,D,W,L,D,D,-29,-31,2,15,29
254,2017-04-15,Hoffenheim,M'gladbach,5,3,H,5,3,27,38,53,39,L,W,W,W,W,D,-22,-35,13,14,29
255,2017-04-15,Leverkusen,Bayern Munich,0,0,D,0,0,43,15,33,66,L,W,W,L,D,W,-43,-15,-28,-33,29
256,2017-04-15,Mainz,Hertha,1,0,H,1,0,43,35,31,40,L,W,L,L,L,L,-42,-35,-7,-9,29
257,2017-04-15,RB Leipzig,Freiburg,4,0,H,4,0,30,50,58,38,W,W,W,W,W,L,-26,-50,24,20,29
258,2017-04-15,Wolfsburg,Ingolstadt,3,0,H,3,0,42,48,32,28,L,W,L,W,D,W,-39,-48,9,4,29
259,2017-04-16,Darmstadt,Schalke 04,2,1,H,2,1,57,32,15,37,L,W,L,L,L,D,-55,-31,-24,-22,29
260,2017-04-16,Werder Bremen,Hamburg,2,1,H,2,1,47,50,39,33,D,W,W,L,W,W,-45,-49,4,6,29
261,2017-04-21,FC Koln,Hoffenheim,1,1,D,1,1,37,28,40,54,L,W,L,L,W,W,-36,-27,-9,-14,30
262,2017-04-22,Bayern Munich,Mainz,2,2,D,2,2,17,45,67,32,D,W,W,L,L,L,-15,-43,28,35,30
263,2017-04-22,Ein Frankfurt,Augsburg,3,1,H,3,1,33,48,41,29,L,W,D,L,L,L,-30,-47,17,12,30
264,2017-04-22,Hamburg,Darmstadt,1,2,A,1,2,52,58,33,18,L,W,W,L,L,L,-51,-56,5,15,30
265,2017-04-22,Hertha,Wolfsburg,1,0,H,1,0,35,43,43,32,L,W,W,L,L,L,-34,-43,9,11,30
266,2017-04-22,Ingolstadt,Werder Bremen,2,4,A,2,4,52,49,28,42,L,W,W,D,W,W,-50,-45,-5,-14,30
267,2017-04-22,M'gladbach,Dortmund,2,3,A,2,3,41,34,39,56,L,W,W,L,W,W,-39,-31,-8,-17,30
268,2017-04-23,Freiburg,Leverkusen,2,1,H,2,1,51,45,41,33,L,D,W,L,W,W,-49,-44,-5,8,30
269,2017-04-23,Schalke 04,RB Leipzig,1,1,D,1,1,33,31,38,59,L,W,W,W,L,W,-32,-30,-2,-21,30
270,2017-04-28,Leverkusen,Schalke 04,1,4,A,1,4,49,34,33,41,L,D,D,L,L,W,-48,-30,-18,-8,31
271,2017-04-29,Darmstadt,Freiburg,3,0,H,3,0,58,54,21,41,W,W,W,L,L,W,-55,-54,-1,-20,31
272,2017-04-29,Dortmund,FC Koln,0,0,D,0,0,34,37,57,41,W,D,W,L,L,L,-34,-37,3,16,31
273,2017-04-29,Mainz,M'gladbach,1,2,A,1,2,47,42,32,42,D,L,W,L,L,W,-46,-40,-6,-10,31
274,2017-04-29,RB Leipzig,Ingolstadt,0,0,D,0,0,31,52,60,29,D,L,W,L,W,W,-31,-52,21,31,31
275,2017-04-29,Werder Bremen,Hertha,2,0,H,2,0,49,37,45,43,W,W,W,L,D,W,-47,-37,-10,2,31
276,2017-04-29,Wolfsburg,Bayern Munich,0,6,A,0,6,49,17,32,70,L,D,W,D,L,W,-49,-11,-38,-38,31
277,2017-04-30,Augsburg,Hamburg,4,0,H,4,0,48,56,32,33,L,L,W,L,L,W,-44,-56,12,-1,31
278,2017-04-30,Hoffenheim,Ein Frankfurt,1,0,H,1,0,28,34,57,41,D,W,W,L,L,D,-27,-34,7,16,31
279,2017-05-05,FC Koln,Werder Bremen,4,3,H,4,3,40,53,44,45,D,W,D,W,L,W,-36,-50,14,-1,32
280,2017-05-06,Bayern Munich,Darmstadt,1,0,H,1,0,17,59,73,21,W,W,D,W,D,W,-16,-59,43,52,32
281,2017-05-06,Dortmund,Hoffenheim,2,1,H,2,1,35,30,60,57,D,W,W,D,W,W,-33,-29,-4,3,32
282,2017-05-06,Ein Frankfurt,Wolfsburg,0,2,A,0,2,36,49,41,35,L,L,W,L,L,W,-36,-47,11,6,32
283,2017-05-06,Hertha,RB Leipzig,1,4,A,1,4,41,32,43,63,L,D,W,D,L,W,-40,-28,-12,-20,32
284,2017-05-06,Ingolstadt,Leverkusen,1,1,D,1,1,53,50,30,34,D,L,L,L,L,D,-52,-49,-3,-4,32
285,2017-05-06,M'gladbach,Augsburg,1,1,D,1,1,43,49,43,33,W,W,L,L,L,W,-42,-48,6,10,32
286,2017-05-07,Freiburg,Schalke 04,2,0,H,2,0,54,36,44,41,L,W,W,D,L,L,-52,-36,-16,3,32
287,2017-05-07,Hamburg,Mainz,0,0,D,0,0,56,47,34,33,L,L,L,D,L,W,-56,-47,-9,1,32
288,2017-05-13,Augsburg,Dortmund,1,1,D,1,1,50,36,34,61,D,W,W,D,L,W,-49,-35,-14,-27,33
289,2017-05-13,Darmstadt,Hertha,0,2,A,0,2,61,41,21,46,L,L,W,L,W,W,-61,-39,-22,-25,33
290,2017-05-13,Freiburg,Ingolstadt,1,1,D,1,1,55,54,45,31,W,D,L,D,W,L,-54,-53,-1,14,33
291,2017-05-13,Leverkusen,FC Koln,2,2,D,2,2,52,42,35,45,D,W,L,D,L,D,-50,-40,-10,-10,33
292,2017-05-13,Mainz,Ein Frankfurt,4,2,H,4,2,49,40,36,41,D,L,L,L,D,W,-45,-38,-7,-5,33
293,2017-05-13,RB Leipzig,Bayern Munich,4,5,A,4,5,37,21,63,76,W,W,D,W,D,D,-33,-16,-17,-13,33
294,2017-05-13,Schalke 04,Hamburg,1,1,D,1,1,37,57,42,35,L,D,W,L,D,L,-36,-56,20,7,33
295,2017-05-13,Werder Bremen,Hoffenheim,3,5,A,3,5,58,33,45,60,L,L,W,W,W,D,-55,-28,-27,-15,33
296,2017-05-13,Wolfsburg,M'gladbach,1,1,D,1,1,50,44,36,44,W,D,L,W,L,L,-49,-43,-6,-8,33
297,2017-05-20,Bayern Munich,Freiburg,4,1,H,4,1,22,59,79,45,W,D,W,W,W,L,-18,-58,40,34,34
298,2017-05-20,Dortmund,Werder Bremen,4,3,H,4,3,39,62,64,45,D,L,W,L,D,W,-35,-59,24,19,34
299,2017-05-20,Ein Frankfurt,RB Leipzig,2,2,D,2,2,42,39,42,64,L,L,L,W,L,D,-40,-37,-3,-22,34
300,2017-05-20,FC Koln,Mainz,2,0,H,2,0,42,51,48,36,D,W,W,D,D,L,-40,-51,11,12,34
301,2017-05-20,Hamburg,Wolfsburg,2,1,H,2,1,58,52,38,36,D,D,D,W,L,L,-56,-51,-5,2,34
302,2017-05-20,Hertha,Leverkusen,2,6,A,2,6,47,54,46,38,W,D,L,D,L,L,-45,-48,3,8,34
303,2017-05-20,Hoffenheim,Augsburg,0,0,D,0,0,33,50,61,35,W,D,L,D,W,W,-33,-50,17,26,34
304,2017-05-20,Ingolstadt,Schalke 04,1,1,D,1,1,55,38,32,43,D,D,D,L,D,W,-54,-37,-17,-11,34
305,2017-05-20,M'gladbach,Darmstadt,2,2,D,2,2,46,63,45,22,D,L,D,L,W,W,-44,-61,17,23,34
306,2015-08-14,Bayern Munich,Hamburg,5,0,H,0,0,0,0,0,0,M,M,M,M,M,M,0,0,0,0,1
307,2015-08-15,Augsburg,Hertha,0,1,A,0,0,0,0,0,0,M,M,M,M,M,M,0,0,0,0,1
308,2015-08-15,Darmstadt,Hannover,2,2,D,0,0,0,0,0,0,M,M,M,M,M,M,0,0,0,0,1
309,2015-08-15,Dortmund,M'gladbach,4,0,H,0,0,0,0,0,0,M,M,M,M,M,M,0,0,0,0,1
310,2015-08-15,Leverkusen,Hoffenheim,2,1,H,0,0,0,0,0,0,M,M,M,M,M,M,0,0,0,0,1
311,2015-08-15,Mainz,Ingolstadt,0,1,A,0,0,0,0,0,0,M,M,M,M,M,M,0,0,0,0,1
312,2015-08-15,Werder Bremen,Schalke 04,0,3,A,0,0,0,0,0,0,M,M,M,M,M,M,0,0,0,0,1
313,2015-08-16,Stuttgart,FC Koln,1,3,A,0,0,0,0,0,0,M,M,M,M,M,M,0,0,0,0,1
314,2015-08-16,Wolfsburg,Ein Frankfurt,2,1,H,0,0,0,0,0,0,M,M,M,M,M,M,0,0,0,0,1
315,2015-08-21,Hertha,Werder Bremen,1,1,D,1,0,0,3,3,0,M,M,M,M,M,M,1,-3,4,3,2
316,2015-08-22,Ein Frankfurt,Augsburg,1,1,D,1,0,2,1,0,0,M,M,M,M,M,M,-1,-1,0,0,2
317,2015-08-22,FC Koln,Wolfsburg,1,1,D,3,2,1,1,3,3,M,M,M,M,M,M,2,1,1,0,2
318,2015-08-22,Hamburg,Stuttgart,3,2,H,0,1,5,3,0,0,M,M,M,M,M,M,-5,-2,-3,0,2
319,2015-08-22,Hannover,Leverkusen,0,1,A,2,2,2,1,1,3,M,M,M,M,M,M,0,1,-1,-2,2
320,2015-08-22,Hoffenheim,Bayern Munich,1,2,A,1,5,2,0,0,3,M,M,M,M,M,M,-1,5,-6,-3,2
321,2015-08-22,Schalke 04,Darmstadt,1,1,D,3,2,0,2,3,1,M,M,M,M,M,M,3,0,3,2,2
322,2015-08-23,Ingolstadt,Dortmund,0,4,A,1,4,0,0,3,3,M,M,M,M,M,M,1,4,-3,0,2
323,2015-08-23,M'gladbach,Mainz,1,2,A,0,0,4,1,0,0,M,M,M,M,M,M,-4,-1,-3,0,2
324,2015-08-28,Wolfsburg,Schalke 04,3,0,H,5,3,1,3,6,3,D,D,M,M,M,M,4,0,4,3,3
325,2015-08-29,Augsburg,Ingolstadt,0,1,A,0,2,2,0,0,6,D,L,M,M,M,M,-2,2,-4,-6,3
326,2015-08-29,Bayern Munich,Leverkusen,3,0,H,8,2,0,4,6,3,W,W,M,M,M,M,8,-2,10,3,3
327,2015-08-29,Darmstadt,Hoffenheim,0,0,D,2,1,2,2,2,1,D,L,M,M,M,M,0,-1,1,1,3
328,2015-08-29,FC Koln,Hamburg,2,1,H,5,1,2,7,6,0,D,W,M,M,M,M,3,-6,9,6,3
329,2015-08-29,Mainz,Hannover,3,0,H,3,2,1,5,3,1,W,L,M,M,M,M,2,-3,5,2,3
330,2015-08-29,Stuttgart,Ein Frankfurt,1,4,A,2,5,7,3,0,3,L,D,M,M,M,M,-5,2,-7,-3,3
331,2015-08-30,Dortmund,Hertha,3,1,H,7,2,1,3,6,3,W,D,M,M,M,M,6,-1,7,3,3
332,2015-08-30,Werder Bremen,M'gladbach,2,1,H,2,1,4,6,3,0,D,L,M,M,M,M,-2,-5,3,3,3
333,2015-09-11,M'gladbach,Hamburg,0,3,A,1,4,9,7,0,3,L,L,L,W,M,M,-8,-3,-5,-3,4
334,2015-09-12,Bayern Munich,Augsburg,2,1,H,10,1,1,4,9,0,W,L,W,D,M,M,9,-3,12,9,4
335,2015-09-12,Ein Frankfurt,FC Koln,6,2,H,11,7,5,8,6,6,W,W,D,D,M,M,6,-1,7,0,4
336,2015-09-12,Hannover,Dortmund,2,4,A,4,11,9,3,1,9,L,W,L,W,M,M,-5,8,-13,-8,4
337,2015-09-12,Hertha,Stuttgart,2,1,H,4,3,4,9,6,0,L,L,D,L,M,M,0,-6,6,6,4
338,2015-09-12,Ingolstadt,Wolfsburg,0,0,D,2,5,0,1,7,7,W,W,L,D,M,M,2,4,-2,0,4
339,2015-09-12,Leverkusen,Darmstadt,0,1,A,2,3,5,2,3,5,L,D,W,D,M,M,-3,1,-4,-2,4
340,2015-09-13,Hoffenheim,Werder Bremen,1,3,A,2,5,5,5,1,6,D,W,L,D,M,M,-3,0,-3,-5,4
341,2015-09-13,Schalke 04,Mainz,2,1,H,5,4,4,3,6,3,L,W,D,W,M,M,1,1,0,3,4
342,2015-09-18,Mainz,Hoffenheim,3,1,H,7,3,4,8,6,1,L,L,W,D,W,L,3,-5,8,5,5
343,2015-09-19,Darmstadt,Bayern Munich,0,3,A,3,13,5,1,5,12,W,W,D,W,D,W,-2,12,-14,-7,5
344,2015-09-19,FC Koln,M'gladbach,1,0,H,8,1,8,10,9,0,L,L,W,L,D,L,0,-9,9,9,5
345,2015-09-19,Hamburg,Ein Frankfurt,0,0,D,4,11,7,5,4,7,W,W,L,W,W,D,-3,6,-9,-3,5
346,2015-09-19,Werder Bremen,Ingolstadt,0,1,A,5,3,6,0,6,10,W,D,W,W,D,L,-1,3,-4,-4,5
347,2015-09-19,Wolfsburg,Hertha,2,0,H,7,4,1,6,10,6,D,W,W,L,D,D,6,-2,8,4,5
348,2015-09-20,Augsburg,Hannover,2,0,H,3,4,4,11,3,1,L,L,L,L,D,L,-1,-7,6,2,5
349,2015-09-20,Dortmund,Leverkusen,3,0,H,14,2,3,8,12,3,W,L,W,L,W,W,11,-6,17,9,5
350,2015-09-20,Stuttgart,Schalke 04,0,1,A,3,6,10,4,0,9,L,W,L,L,L,D,-7,2,-9,-9,5
351,2015-09-22,Bayern Munich,Wolfsburg,5,1,H,18,8,2,6,15,10,W,W,W,D,W,W,16,2,14,5,6
352,2015-09-22,Darmstadt,Werder Bremen,2,1,H,5,6,6,8,8,6,L,L,W,W,D,W,-1,-2,1,2,6
353,2015-09-22,Hertha,FC Koln,2,0,H,6,8,6,10,9,9,L,W,W,L,L,W,0,-2,2,0,6
354,2015-09-22,Ingolstadt,Hamburg,0,1,A,3,5,1,7,10,7,W,D,D,W,W,L,2,-2,4,3,6
355,2015-09-23,Hannover,Stuttgart,1,3,A,5,6,14,11,1,3,L,L,L,L,L,L,-9,-5,-4,-2,6
356,2015-09-23,Hoffenheim,Dortmund,1,1,D,4,15,9,4,2,13,L,W,L,W,D,W,-5,11,-16,-11,6
357,2015-09-23,Leverkusen,Mainz,1,0,H,3,7,8,5,6,6,L,W,L,L,L,W,-5,2,-7,0,6
358,2015-09-23,M'gladbach,Augsburg,4,2,H,5,5,12,8,3,3,L,W,L,L,L,L,-7,-3,-4,0,6
359,2015-09-23,Schalke 04,Ein Frankfurt,2,0,H,8,11,4,7,12,7,W,D,W,W,L,W,4,4,0,5,6
360,2015-09-25,FC Koln,Ingolstadt,1,1,D,9,4,11,2,10,11,L,L,W,W,L,D,-2,2,-4,-1,7
361,2015-09-26,Augsburg,Hoffenheim,1,3,A,6,7,11,10,3,5,L,D,W,L,L,L,-5,-3,-2,-2,7
362,2015-09-26,Hamburg,Schalke 04,0,1,A,5,9,8,4,7,15,W,W,D,W,W,W,-3,5,-8,-8,7
363,2015-09-26,Mainz,Bayern Munich,0,3,A,7,21,8,2,6,18,L,W,W,W,L,W,-1,19,-20,-12,7
364,2015-09-26,Stuttgart,M'gladbach,1,3,A,7,8,14,13,3,6,W,W,L,L,L,L,-7,-5,-2,-3,7
365,2015-09-26,Werder Bremen,Leverkusen,0,3,A,6,6,11,8,6,9,L,W,L,L,W,L,-5,-2,-3,-3,7
366,2015-09-26,Wolfsburg,Hannover,1,1,D,9,6,7,15,11,2,L,L,W,L,D,L,2,-9,11,9,7
367,2015-09-27,Dortmund,Darmstadt,2,2,D,17,7,6,8,14,9,D,W,W,L,W,W,11,-1,12,5,7
368,2015-09-27,Ein Frankfurt,Hertha,1,1,D,12,7,8,7,8,10,L,W,D,L,W,W,4,0,4,-2,7
369,2015-10-02,Darmstadt,Mainz,2,3,A,9,10,11,10,9,9,D,L,W,L,L,W,-2,0,-2,0,8
370,2015-10-03,Hannover,Werder Bremen,1,0,H,7,6,15,12,5,6,D,L,L,L,L,L,-8,-6,-2,-1,8
371,2015-10-03,Hertha,Hamburg,3,0,H,10,5,7,11,13,7,D,L,W,W,L,D,3,-6,9,6,8
372,2015-10-03,Hoffenheim,Stuttgart,2,2,D,9,9,12,16,6,4,W,L,D,W,L,L,-3,-7,4,2,8
373,2015-10-03,Ingolstadt,Ein Frankfurt,2,0,H,6,12,2,10,14,8,D,D,L,L,W,D,4,2,2,6,8
374,2015-10-03,M'gladbach,Wolfsburg,2,0,H,10,9,13,9,9,11,W,D,W,L,L,W,-3,0,-3,-2,8
375,2015-10-04,Bayern Munich,Dortmund,5,1,H,26,18,3,11,21,14,W,D,W,D,W,W,23,7,16,7,8
376,2015-10-04,Leverkusen,Augsburg,1,1,D,7,7,9,12,10,4,W,L,W,L,L,W,-2,-5,3,6,8
377,2015-10-04,Schalke 04,FC Koln,0,3,A,9,12,7,11,15,13,W,D,W,L,W,W,2,1,1,2,8
378,2015-10-16,Mainz,Dortmund,0,2,A,10,20,12,11,9,17,W,L,L,D,L,D,-2,9,-11,-8,9
379,2015-10-17,Augsburg,Darmstadt,0,2,A,7,11,14,11,4,12,D,L,L,D,L,W,-7,0,-7,-8,9
380,2015-10-17,Ein Frankfurt,M'gladbach,1,5,A,13,15,15,14,8,12,L,W,D,W,L,W,-2,1,-3,-4,9
381,2015-10-17,Hamburg,Leverkusen,0,0,D,5,7,11,9,8,11,L,D,L,W,W,W,-6,-2,-4,-3,9
382,2015-10-17,Schalke 04,Hertha,2,1,H,11,11,8,9,18,13,L,W,W,D,W,W,3,2,1,5,9
383,2015-10-17,Werder Bremen,Bayern Munich,0,1,A,6,27,13,3,6,24,L,W,L,W,L,W,-7,24,-31,-18,9
384,2015-10-17,Wolfsburg,Hoffenheim,4,2,H,13,11,11,16,14,6,L,D,D,W,L,D,2,-5,7,8,9
385,2015-10-18,FC Koln,Hannover,0,1,A,12,8,12,15,13,8,W,W,D,D,L,L,0,-7,7,5,9
386,2015-10-18,Stuttgart,Ingolstadt,1,0,H,10,6,16,3,7,14,D,W,L,D,W,L,-6,3,-9,-7,9
387,2015-10-23,Hoffenheim,Hamburg,0,1,A,11,6,17,11,6,11,L,D,D,L,W,L,-6,-5,-1,-5,10
388,2015-10-24,Bayern Munich,FC Koln,4,0,H,31,12,3,16,27,13,W,L,W,W,W,D,28,-4,32,14,10
389,2015-10-24,Darmstadt,Wolfsburg,0,1,A,11,14,12,11,12,17,W,W,L,L,D,D,-1,3,-4,-5,10
390,2015-10-24,Hannover,Ein Frankfurt,1,2,A,9,15,17,16,8,11,W,L,W,L,D,D,-8,-1,-7,-3,10
391,2015-10-24,Ingolstadt,Hertha,0,1,A,6,12,4,9,14,16,L,L,W,W,D,D,2,3,-1,-2,10
392,2015-10-24,Leverkusen,Stuttgart,4,3,H,11,13,12,20,14,7,D,W,D,D,W,L,-1,-7,6,7,10
393,2015-10-24,Mainz,Werder Bremen,1,3,A,11,9,15,14,9,9,L,L,W,L,L,L,-4,-5,1,0,10
394,2015-10-25,Dortmund,Augsburg,5,1,H,25,8,12,19,20,4,W,L,L,D,D,L,13,-11,24,16,10
395,2015-10-25,M'gladbach,Schalke 04,3,1,H,18,12,15,11,15,18,W,W,W,L,W,W,3,1,2,-3,10
396,2015-10-30,Ein Frankfurt,Bayern Munich,0,0,D,15,31,16,3,12,28,W,W,L,W,L,W,-1,28,-29,-16,11
397,2015-10-31,Augsburg,Mainz,3,3,D,11,14,22,18,5,10,L,L,L,L,D,W,-11,-4,-7,-5,11
398,2015-10-31,FC Koln,Hoffenheim,0,0,D,12,11,16,17,14,7,L,L,L,L,W,D,-4,-6,2,7,11
399,2015-10-31,Hertha,M'gladbach,1,4,A,13,22,13,16,16,18,W,W,L,W,W,W,0,6,-6,-2,11
400,2015-10-31,Schalke 04,Ingolstadt,1,1,D,13,7,12,5,19,15,L,L,W,L,L,W,1,2,-1,4,11
401,2015-10-31,Werder Bremen,Dortmund,1,3,A,10,28,17,13,9,23,W,W,L,W,L,L,-7,15,-22,-14,11
402,2015-10-31,Wolfsburg,Leverkusen,2,1,H,16,12,12,14,20,14,W,W,W,D,L,D,4,-2,6,6,11
403,2015-11-01,Hamburg,Hannover,1,2,A,7,11,13,18,11,11,W,L,D,W,L,W,-6,-7,1,0,11
404,2015-11-01,Stuttgart,Darmstadt,2,0,H,15,11,20,14,10,12,L,L,W,W,D,L,-5,-3,-2,-2,11
405,2015-11-06,Hannover,Hertha,1,3,A,12,16,21,14,11,19,W,L,L,W,W,L,-9,2,-11,-8,12
406,2015-11-07,Bayern Munich,Stuttgart,4,0,H,35,15,3,24,31,10,D,W,W,L,W,W,32,-9,41,21,12
407,2015-11-07,Darmstadt,Hamburg,1,1,D,12,8,15,14,13,12,L,L,L,W,W,D,-3,-6,3,1,12
408,2015-11-07,Hoffenheim,Ein Frankfurt,0,0,D,11,15,17,16,8,13,D,D,L,W,L,L,-6,-1,-5,-5,12
409,2015-11-07,Leverkusen,FC Koln,1,2,A,13,14,16,17,14,17,L,D,W,L,D,L,-3,-3,0,-3,12
410,2015-11-07,Mainz,Wolfsburg,2,0,H,16,16,18,14,13,20,D,W,L,W,L,W,-2,2,-4,-7,12
411,2015-11-07,M'gladbach,Ingolstadt,0,0,D,22,7,16,5,19,16,W,D,W,L,W,L,6,2,4,3,12
412,2015-11-08,Augsburg,Werder Bremen,1,2,A,12,12,24,18,5,12,D,L,L,W,L,L,-12,-6,-6,-7,12
413,2015-11-08,Dortmund,Schalke 04,3,2,H,31,15,15,15,26,19,W,D,W,L,W,W,16,0,16,7,12
414,2015-11-20,Hamburg,Dortmund,3,1,H,11,32,15,18,15,26,D,W,L,W,W,W,-4,14,-18,-11,13
415,2015-11-21,Ein Frankfurt,Leverkusen,1,3,A,16,16,19,17,13,17,D,L,D,L,W,W,-3,-1,-2,-4,13
416,2015-11-21,FC Koln,Mainz,0,0,D,14,16,17,18,18,14,W,W,D,D,L,L,-3,-2,-1,4,13
417,2015-11-21,M'gladbach,Hannover,2,1,H,24,13,17,23,22,11,D,L,W,W,W,L,7,-10,17,11,13
418,2015-11-21,Schalke 04,Bayern Munich,1,3,A,16,38,18,4,19,34,L,W,D,D,L,W,-2,34,-36,-15,13
419,2015-11-21,Stuttgart,Augsburg,0,4,A,15,16,28,24,10,8,L,L,W,D,L,L,-13,-8,-5,2,13
420,2015-11-21,Wolfsburg,Werder Bremen,6,0,H,22,12,14,24,23,12,L,W,W,L,W,W,8,-12,20,11,13
421,2015-11-22,Hertha,Hoffenheim,1,0,H,17,11,14,18,22,8,W,D,L,D,W,L,3,-7,10,14,13
422,2015-11-22,Ingolstadt,Darmstadt,3,1,H,10,13,6,18,19,13,D,D,D,L,L,L,4,-5,9,6,13
423,2015-11-27,Darmstadt,FC Koln,0,0,D,13,14,18,17,14,19,L,D,D,W,L,D,-5,-3,-2,-5,14
424,2015-11-28,Bayern Munich,Hertha,2,0,H,40,17,4,16,37,22,W,W,W,W,D,L,36,1,35,15,14
425,2015-11-28,Hannover,Ingolstadt,4,0,H,17,10,23,10,14,19,L,W,L,D,W,D,-6,0,-6,-5,14
426,2015-11-28,Hoffenheim,M'gladbach,3,3,D,14,27,21,20,9,23,L,W,D,D,D,W,-7,7,-14,-14,14
427,2015-11-28,Mainz,Ein Frankfurt,2,1,H,18,17,19,21,17,13,D,L,W,D,D,D,-1,-4,3,4,14
428,2015-11-28,Werder Bremen,Hamburg,1,3,A,13,14,27,16,12,18,L,W,W,D,L,L,-14,-2,-12,-6,14
429,2015-11-29,Augsburg,Wolfsburg,0,0,D,16,22,24,14,9,24,W,W,L,L,D,W,-8,8,-16,-15,14
430,2015-11-29,Dortmund,Stuttgart,4,1,H,36,16,19,32,29,10,L,L,W,L,W,W,17,-16,33,19,14
431,2015-11-29,Leverkusen,Schalke 04,1,1,D,17,17,18,19,18,20,W,L,L,L,L,D,-1,-2,1,-2,14
432,2015-12-04,Schalke 04,Hannover,3,1,H,20,18,20,26,23,14,D,W,L,L,L,L,0,-8,8,9,15
433,2015-12-05,FC Koln,Augsburg,0,1,A,14,17,18,24,19,12,D,D,D,W,W,L,-4,-7,3,7,15
434,2015-12-05,Hamburg,Mainz,1,3,A,15,21,19,20,18,20,W,W,W,D,D,W,-4,1,-5,-2,15
435,2015-12-05,Hertha,Leverkusen,2,1,H,19,18,17,20,25,18,L,D,W,W,W,L,2,-2,4,7,15
436,2015-12-05,Ingolstadt,Hoffenheim,1,1,D,11,15,11,22,20,10,L,D,W,L,D,D,0,-7,7,10,15
437,2015-12-05,M'gladbach,Bayern Munich,3,1,H,30,41,21,7,26,37,D,W,W,W,D,W,9,34,-25,-11,15
438,2015-12-05,Wolfsburg,Dortmund,1,2,A,23,38,16,20,24,32,D,W,W,L,L,W,7,18,-11,-8,15
439,2015-12-06,Ein Frankfurt,Darmstadt,0,1,A,17,14,22,18,13,17,L,D,L,L,D,D,-5,-4,-1,-4,15
440,2015-12-06,Stuttgart,Werder Bremen,1,1,D,17,14,33,28,11,13,L,L,L,L,L,W,-16,-14,-2,-2,15
441,2015-12-11,Mainz,Stuttgart,0,0,D,21,17,20,33,21,12,W,D,W,L,D,L,1,-16,17,9,16
442,2015-12-12,Bayern Munich,Ingolstadt,2,0,H,43,11,7,13,40,20,L,D,W,L,W,W,36,-2,38,20,16
443,2015-12-12,Darmstadt,Hertha,0,4,A,14,23,22,17,17,28,W,W,D,L,L,W,-8,6,-14,-11,16
444,2015-12-12,Hoffenheim,Hannover,1,0,H,16,18,22,27,13,14,D,L,D,W,L,L,-6,-9,3,-1,16
445,2015-12-12,Leverkusen,M'gladbach,5,0,H,23,30,20,26,21,26,L,W,D,D,W,W,3,4,-1,-5,16
446,2015-12-12,Werder Bremen,FC Koln,1,1,D,15,15,29,19,14,20,D,L,L,D,L,D,-14,-4,-10,-6,16
447,2015-12-12,Wolfsburg,Hamburg,1,1,D,24,16,17,20,25,19,L,L,D,W,W,W,7,-4,11,6,16
448,2015-12-13,Augsburg,Schalke 04,2,1,H,19,21,25,22,15,23,W,W,D,D,W,L,-6,-1,-5,-8,16
449,2015-12-13,Dortmund,Ein Frankfurt,4,1,H,42,18,21,26,35,13,W,L,W,L,L,L,21,-8,29,22,16
450,2015-12-18,Schalke 04,Hoffenheim,1,0,H,22,16,22,23,26,13,L,W,W,D,D,D,0,-7,7,13,17
451,2015-12-19,Ein Frankfurt,Werder Bremen,2,1,H,20,16,27,31,16,14,L,D,L,D,L,L,-7,-15,8,2,17
452,2015-12-19,FC Koln,Dortmund,2,1,H,17,43,20,23,23,35,D,W,L,W,D,W,-3,20,-23,-12,17
453,2015-12-19,Hamburg,Augsburg,0,1,A,16,20,21,25,19,18,D,W,L,W,W,D,-5,-5,0,1,17
454,2015-12-19,Hannover,Bayern Munich,0,1,A,18,44,28,7,14,43,L,W,L,L,W,W,-10,37,-47,-29,17
455,2015-12-19,Ingolstadt,Leverkusen,0,1,A,11,24,14,20,20,24,L,W,D,L,L,D,-3,4,-7,-4,17
456,2015-12-19,Stuttgart,Wolfsburg,3,1,H,20,25,34,20,15,25,D,D,D,L,L,D,-14,5,-19,-10,17
457,2015-12-20,Hertha,Mainz,2,0,H,25,21,17,22,31,21,W,D,W,W,L,W,8,-1,9,10,17
458,2015-12-20,M'gladbach,Darmstadt,3,2,H,33,16,28,25,29,17,L,L,W,W,D,D,5,-9,14,12,17
459,2016-01-22,Hamburg,Bayern Munich,1,2,A,17,46,23,8,19,46,L,W,D,W,L,L,-6,38,-44,-27,18
460,2016-01-23,FC Koln,Stuttgart,1,3,A,18,23,23,35,23,18,W,W,D,D,L,D,-5,-12,7,5,18
461,2016-01-23,Hannover,Darmstadt,1,2,A,19,18,30,26,14,20,L,L,L,L,L,W,-11,-8,-3,-6,18
462,2016-01-23,Hertha,Augsburg,0,0,D,25,20,17,25,32,19,W,W,W,W,W,W,8,-5,13,13,18
463,2016-01-23,Hoffenheim,Leverkusen,1,1,D,17,25,24,21,14,25,L,W,W,W,D,L,-7,4,-11,-11,18
464,2016-01-23,Ingolstadt,Mainz,1,0,H,12,21,14,23,23,21,L,L,L,D,D,W,-2,-2,0,2,18
465,2016-01-23,M'gladbach,Dortmund,1,3,A,34,46,31,24,29,38,W,L,L,W,W,W,3,22,-19,-9,18
466,2016-01-24,Ein Frankfurt,Wolfsburg,3,2,H,23,27,29,23,19,25,W,L,L,D,L,L,-6,4,-10,-6,18
467,2016-01-24,Schalke 04,Werder Bremen,1,3,A,23,19,25,32,26,17,W,L,L,D,W,D,-2,-13,11,9,18
468,2016-01-29,Mainz,M'gladbach,1,0,H,22,34,23,32,24,29,L,L,L,W,D,L,-1,2,-3,-5,19
469,2016-01-30,Augsburg,Ein Frankfurt,0,0,D,20,23,25,29,20,20,D,W,W,W,W,L,-5,-6,1,0,19
470,2016-01-30,Darmstadt,Schalke 04,0,2,A,18,25,28,25,20,29,W,L,L,W,L,L,-10,0,-10,-9,19
471,2016-01-30,Dortmund,Ingolstadt,2,0,H,48,12,24,16,41,23,W,W,L,L,W,L,24,-4,28,18,19
472,2016-01-30,Leverkusen,Hannover,3,0,H,28,19,21,33,28,14,D,L,W,L,W,L,7,-14,21,14,19
473,2016-01-30,Stuttgart,Hamburg,2,1,H,25,18,36,25,21,19,W,L,W,L,D,D,-11,-7,-4,2,19
474,2016-01-30,Werder Bremen,Hertha,3,3,D,22,28,35,20,18,33,W,D,L,W,D,W,-13,8,-21,-15,19
475,2016-01-31,Bayern Munich,Hoffenheim,2,0,H,48,17,8,26,49,14,W,D,W,L,W,W,40,-9,49,35,19
476,2016-01-31,Wolfsburg,FC Koln,1,1,D,28,19,24,24,26,24,L,L,L,W,D,D,4,-5,9,2,19
477,2016-02-05,M'gladbach,Werder Bremen,5,1,H,39,23,33,40,32,18,L,D,L,W,W,L,6,-17,23,14,20
478,2016-02-06,Ein Frankfurt,Stuttgart,2,4,A,25,29,33,38,20,24,D,W,W,W,W,W,-8,-9,1,-4,20
479,2016-02-06,Hannover,Mainz,0,1,A,19,23,34,23,14,27,L,W,L,L,L,L,-15,0,-15,-13,20
480,2016-02-06,Hertha,Dortmund,0,0,D,28,48,20,24,34,42,D,W,D,W,W,L,8,24,-16,-8,20
481,2016-02-06,Ingolstadt,Augsburg,2,1,H,14,21,17,27,26,20,L,D,W,D,L,W,-3,-6,3,6,20
482,2016-02-06,Leverkusen,Bayern Munich,0,0,D,28,48,21,8,29,50,W,W,D,W,W,W,7,40,-33,-21,20
483,2016-02-06,Schalke 04,Wolfsburg,3,0,H,28,28,25,27,32,26,W,D,L,L,W,L,3,1,2,6,20
484,2016-02-07,Hamburg,FC Koln,1,1,D,19,20,26,25,20,25,L,D,L,L,L,W,-7,-5,-2,-5,20
485,2016-02-07,Hoffenheim,Darmstadt,0,2,A,17,20,28,28,14,23,L,L,D,W,L,L,-11,-8,-3,-9,20
486,2016-02-12,Mainz,Schalke 04,2,1,H,25,29,24,27,30,32,W,W,W,W,L,L,1,2,-1,-2,21
487,2016-02-13,Darmstadt,Leverkusen,1,2,A,21,30,30,22,23,32,W,D,L,W,W,D,-9,8,-17,-9,21
488,2016-02-13,Dortmund,Hannover,1,0,H,49,19,24,35,45,14,D,L,W,L,W,L,25,-16,41,31,21
489,2016-02-13,FC Koln,Ein Frankfurt,3,1,H,23,26,26,36,28,20,D,L,D,D,L,W,-3,-10,7,8,21
490,2016-02-13,Stuttgart,Hertha,2,0,H,31,28,38,22,27,34,W,D,W,D,W,D,-7,6,-13,-7,21
491,2016-02-13,Werder Bremen,Hoffenheim,1,1,D,24,18,41,29,19,15,L,L,D,L,W,D,-17,-11,-6,4,21
492,2016-02-13,Wolfsburg,Ingolstadt,2,0,H,30,14,27,19,29,26,L,W,D,L,L,W,3,-5,8,3,21
493,2016-02-14,Augsburg,Bayern Munich,1,3,A,22,51,30,9,20,53,L,D,D,W,D,W,-8,42,-50,-33,21
494,2016-02-14,Hamburg,M'gladbach,3,2,H,22,41,28,36,23,32,D,W,L,L,L,L,-6,5,-11,-9,21
495,2016-02-19,Ein Frankfurt,Hamburg,0,0,D,0,0,36,28,21,24,L,W,L,D,D,L,-36,-28,-8,-3,22
496,2016-02-20,Bayern Munich,Darmstadt,3,1,H,3,1,10,33,56,23,W,L,D,W,W,L,-7,-32,25,33,22
497,2016-02-20,Hertha,Wolfsburg,1,1,D,1,1,23,28,35,30,L,W,D,L,D,D,-22,-27,5,5,22
498,2016-02-20,Hoffenheim,Mainz,3,2,H,3,2,31,27,18,30,D,W,L,W,L,W,-28,-25,-3,-12,22
499,2016-02-20,Ingolstadt,Werder Bremen,2,0,H,2,0,19,43,29,19,L,D,W,L,L,D,-17,-43,26,10,22
500,2016-02-20,M'gladbach,FC Koln,1,0,H,1,0,36,27,35,28,L,W,W,D,L,D,-35,-27,-8,7,22
501,2016-02-21,Hannover,Augsburg,0,1,A,0,1,36,30,14,23,L,L,L,L,L,D,-36,-29,-7,-9,22
502,2016-02-21,Leverkusen,Dortmund,0,1,A,0,1,23,24,32,48,W,W,D,D,W,W,-23,-23,0,-16,22
503,2016-02-21,Schalke 04,Stuttgart,1,1,D,1,1,28,39,33,28,L,W,W,W,W,W,-27,-38,11,5,22
504,2016-02-26,FC Koln,Hertha,0,1,A,0,1,28,23,28,38,L,D,W,L,D,D,-28,-22,-6,-10,23
505,2016-02-27,Hamburg,Ingolstadt,1,1,D,1,1,29,20,25,30,D,W,W,L,D,W,-28,-19,-9,-5,23
506,2016-02-27,Stuttgart,Hannover,1,2,A,1,2,41,37,28,17,D,L,W,L,W,L,-40,-35,-5,11,23
507,2016-02-27,Werder Bremen,Darmstadt,2,2,D,2,2,45,35,20,24,L,L,D,L,L,W,-43,-33,-10,-4,23
508,2016-02-27,Wolfsburg,Bayern Munich,0,2,A,0,2,30,10,30,59,D,W,W,W,L,D,-30,-8,-22,-29,23
509,2016-02-28,Augsburg,M'gladbach,2,2,D,2,2,32,38,24,36,W,W,L,L,L,W,-30,-36,6,-12,23
510,2016-02-28,Dortmund,Hoffenheim,3,1,H,3,1,25,34,51,18,W,W,W,D,D,L,-22,-33,11,33,23
511,2016-02-28,Ein Frankfurt,Schalke 04,0,0,D,0,0,36,28,22,34,D,D,L,L,L,W,-36,-28,-8,-12,23
512,2016-02-28,Mainz,Leverkusen,3,1,H,3,1,28,26,33,32,L,L,W,W,W,D,-25,-25,0,1,23
513,2016-03-01,Hannover,Wolfsburg,0,4,A,0,4,41,30,17,33,W,L,L,D,L,W,-41,-26,-15,-16,24
514,2016-03-01,Ingolstadt,FC Koln,1,1,D,1,1,21,29,31,29,D,L,W,L,L,W,-20,-28,8,2,24
515,2016-03-02,Bayern Munich,Mainz,1,2,A,1,2,12,29,59,36,W,W,W,L,W,W,-11,-27,16,23,24
516,2016-03-02,Darmstadt,Dortmund,0,2,A,0,2,37,25,24,54,D,W,L,W,L,W,-37,-23,-14,-30,24
517,2016-03-02,Hertha,Ein Frankfurt,2,0,H,2,0,23,38,41,22,W,D,D,D,L,L,-21,-38,17,19,24
518,2016-03-02,Hoffenheim,Augsburg,2,1,H,2,1,35,34,21,24,L,D,W,W,D,L,-33,-33,0,-3,24
519,2016-03-02,Leverkusen,Werder Bremen,1,4,A,1,4,30,46,32,23,L,D,L,L,W,D,-29,-42,13,9,24
520,2016-03-02,M'gladbach,Stuttgart,4,0,H,4,0,38,45,39,28,D,L,W,D,L,W,-34,-45,11,11,24
521,2016-03-02,Schalke 04,Hamburg,3,2,H,3,2,30,32,37,25,D,D,D,D,L,W,-27,-30,3,12,24
522,2016-03-05,Augsburg,Leverkusen,3,3,D,3,3,37,33,25,33,L,L,D,L,W,L,-34,-30,-4,-8,25
523,2016-03-05,Dortmund,Bayern Munich,0,0,D,0,0,25,12,55,60,W,L,W,W,W,W,-25,-12,-13,-5,25
524,2016-03-05,Ein Frankfurt,Ingolstadt,1,1,D,1,1,39,22,23,32,L,D,D,D,D,W,-38,-21,-17,-9,25
525,2016-03-05,FC Koln,Schalke 04,1,3,A,1,3,32,31,29,40,D,W,L,D,L,D,-31,-28,-3,-11,25
526,2016-03-05,Stuttgart,Hoffenheim,5,1,H,5,1,46,40,31,21,L,W,L,L,D,W,-41,-39,-2,10,25
527,2016-03-05,Werder Bremen,Hannover,4,1,H,4,1,47,45,26,17,W,L,D,W,L,L,-43,-44,1,9,25
528,2016-03-05,Wolfsburg,M'gladbach,2,1,H,2,1,31,40,36,39,W,W,L,D,D,W,-29,-39,10,-3,25
529,2016-03-06,Hamburg,Hertha,2,0,H,2,0,32,25,28,41,L,W,D,W,D,D,-30,-25,-5,-13,25
530,2016-03-06,Mainz,Darmstadt,0,0,D,0,0,29,37,37,25,W,L,W,D,L,L,-29,-37,8,12,25
531,2016-03-11,Hertha,Schalke 04,2,0,H,2,0,25,33,44,40,L,W,W,W,W,D,-23,-33,10,4,26
532,2016-03-12,Bayern Munich,Werder Bremen,5,0,H,5,0,12,52,63,26,D,W,L,W,W,D,-7,-52,45,37,26
533,2016-03-12,Darmstadt,Augsburg,2,2,D,2,2,39,39,26,26,D,D,L,L,D,D,-37,-37,0,0,26
534,2016-03-12,Hannover,FC Koln,0,2,A,0,2,47,32,17,32,L,L,L,D,W,L,-47,-30,-17,-15,26
535,2016-03-12,Hoffenheim,Wolfsburg,1,0,H,1,0,40,32,24,36,L,W,W,W,L,L,-39,-32,-7,-12,26
536,2016-03-12,Ingolstadt,Stuttgart,3,3,D,3,3,25,49,33,32,D,W,D,L,D,L,-22,-46,24,1,26
537,2016-03-12,M'gladbach,Ein Frankfurt,3,0,H,3,0,40,42,42,23,L,D,W,L,D,D,-37,-42,5,19,26
538,2016-03-13,Dortmund,Mainz,2,0,H,2,0,25,31,58,37,D,D,W,W,W,W,-23,-31,8,21,26
539,2016-03-13,Leverkusen,Hamburg,1,0,H,1,0,33,33,36,28,D,W,L,L,L,D,-32,-33,1,8,26
540,2016-03-18,Schalke 04,M'gladbach,2,1,H,2,1,34,42,43,42,L,W,W,L,W,W,-32,-41,9,1,27
541,2016-03-19,Ein Frankfurt,Hannover,1,0,H,1,0,42,48,26,17,L,L,D,L,L,L,-41,-48,7,9,27
542,2016-03-19,FC Koln,Bayern Munich,0,1,A,0,1,33,12,32,66,W,W,L,D,D,L,-33,-11,-22,-34,27
543,2016-03-19,Hamburg,Hoffenheim,1,3,A,1,3,36,41,28,27,L,W,W,L,L,W,-35,-38,3,1,27
544,2016-03-19,Hertha,Ingolstadt,2,1,H,2,1,26,27,47,33,W,D,L,D,W,D,-24,-26,2,14,27
545,2016-03-19,Werder Bremen,Mainz,1,1,D,1,1,53,32,27,38,L,L,W,D,W,W,-52,-31,-21,-11,27
546,2016-03-19,Wolfsburg,Darmstadt,1,1,D,1,1,33,40,37,27,L,D,W,D,W,L,-32,-39,7,10,27
547,2016-03-20,Augsburg,Dortmund,1,3,A,1,3,42,26,26,61,D,W,D,D,L,W,-41,-23,-18,-35,27
548,2016-03-20,Stuttgart,Leverkusen,0,2,A,0,2,51,33,32,39,D,W,W,D,L,L,-51,-31,-20,-7,27
549,2016-04-01,Leverkusen,Wolfsburg,3,0,H,3,0,33,36,42,37,W,D,W,L,D,W,-30,-36,6,5,28
550,2016-04-02,Bayern Munich,Ein Frankfurt,1,0,H,1,0,12,43,69,26,W,W,W,L,D,D,-11,-43,32,43,28
551,2016-04-02,Darmstadt,Stuttgart,2,2,D,2,2,42,53,28,33,D,L,D,D,D,W,-40,-51,11,-5,28
552,2016-04-02,Dortmund,Werder Bremen,3,2,H,3,2,28,56,64,27,W,D,W,L,D,W,-25,-54,29,37,28
553,2016-04-02,Hannover,Hamburg,0,3,A,0,3,51,36,17,31,L,L,L,L,L,W,-51,-33,-18,-14,28
554,2016-04-02,Ingolstadt,Schalke 04,3,0,H,3,0,27,37,36,43,L,W,D,L,D,W,-24,-37,13,-7,28
555,2016-04-02,Mainz,Augsburg,4,2,H,4,2,34,46,41,26,D,L,L,D,D,D,-30,-44,14,15,28
556,2016-04-03,Hoffenheim,FC Koln,1,1,D,1,1,42,34,28,33,W,L,W,W,L,L,-41,-33,-8,-5,28
557,2016-04-03,M'gladbach,Hertha,5,0,H,5,0,42,31,45,47,L,W,W,W,L,L,-37,-31,-6,-2,28
558,2016-04-08,Hertha,Hannover,2,2,D,2,2,33,53,48,18,L,L,W,L,W,L,-31,-51,20,30,29
559,2016-04-09,Ein Frankfurt,Hoffenheim,0,2,A,0,2,45,42,26,31,L,D,W,W,L,W,-45,-40,-5,-5,29
560,2016-04-09,Hamburg,Darmstadt,1,2,A,1,2,38,43,31,31,W,D,L,D,L,D,-37,-41,4,0,29
561,2016-04-09,Ingolstadt,M'gladbach,1,0,H,1,0,27,43,39,45,W,W,L,L,D,W,-26,-43,17,-6,29
562,2016-04-09,Stuttgart,Bayern Munich,1,3,A,1,3,56,13,33,72,D,W,L,W,D,W,-55,-10,-45,-39,29
563,2016-04-09,Werder Bremen,Augsburg,1,2,A,1,2,58,47,27,29,L,L,D,L,L,D,-57,-45,-12,-2,29
564,2016-04-09,Wolfsburg,Mainz,1,1,D,1,1,37,35,38,42,L,W,D,D,L,L,-36,-34,-2,-4,29
565,2016-04-10,FC Koln,Leverkusen,0,2,A,0,2,36,33,33,45,D,W,L,W,W,W,-36,-31,-5,-12,29
566,2016-04-10,Schalke 04,Dortmund,2,2,D,2,2,39,30,44,65,L,W,W,W,L,W,-37,-28,-9,-21,29
567,2016-04-15,Hannover,M'gladbach,2,0,H,2,0,53,45,21,45,D,L,L,W,L,L,-51,-45,-6,-24,30
568,2016-04-16,Augsburg,Stuttgart,1,0,H,1,0,47,57,32,33,W,L,L,D,L,L,-46,-57,11,-1,30
569,2016-04-16,Bayern Munich,Schalke 04,3,0,H,3,0,13,42,75,44,W,D,W,L,W,W,-10,-42,32,31,30
570,2016-04-16,Darmstadt,Ingolstadt,2,0,H,2,0,43,29,34,39,W,W,D,W,D,L,-41,-29,-12,-5,30
571,2016-04-16,Hoffenheim,Hertha,2,1,H,2,1,43,35,34,48,W,D,D,L,W,W,-41,-34,-7,-14,30
572,2016-04-16,Leverkusen,Ein Frankfurt,3,0,H,3,0,33,48,48,26,W,L,W,L,W,W,-30,-48,18,22,30
573,2016-04-16,Werder Bremen,Wolfsburg,3,2,H,3,2,60,40,30,38,L,D,L,L,D,D,-57,-38,-19,-8,30
574,2016-04-17,Dortmund,Hamburg,3,0,H,3,0,30,41,68,31,D,L,W,W,W,L,-27,-41,14,37,30
575,2016-04-17,Mainz,FC Koln,2,3,A,2,3,38,38,42,36,D,L,W,D,D,L,-36,-35,-1,6,30
576,2016-04-22,Hamburg,Werder Bremen,2,1,H,2,1,42,62,34,30,L,W,L,L,W,L,-40,-61,21,4,31
577,2016-04-23,FC Koln,Darmstadt,4,1,H,4,1,39,47,39,34,W,W,L,W,D,D,-35,-46,11,5,31
578,2016-04-23,Hertha,Bayern Munich,0,2,A,0,2,37,13,48,78,L,W,D,W,L,W,-37,-11,-26,-30,31
579,2016-04-23,Ingolstadt,Hannover,2,2,D,2,2,31,55,40,22,L,W,W,D,W,L,-29,-53,24,18,31
580,2016-04-23,Schalke 04,Leverkusen,2,3,A,2,3,45,35,44,51,L,W,D,W,L,W,-43,-32,-11,-7,31
581,2016-04-23,Stuttgart,Dortmund,0,3,A,0,3,60,30,33,71,L,W,L,D,D,W,-60,-27,-33,-38,31
582,2016-04-23,Wolfsburg,Augsburg,0,2,A,0,2,42,47,38,35,L,W,D,W,L,L,-42,-45,3,3,31
583,2016-04-24,Ein Frankfurt,Mainz,2,1,H,2,1,49,40,29,42,L,L,L,D,L,W,-47,-39,-8,-13,31
584,2016-04-24,M'gladbach,Hoffenheim,3,1,H,3,1,46,46,48,34,L,W,L,W,W,D,-43,-45,2,14,31
585,2016-04-29,Augsburg,FC Koln,0,0,D,0,0,47,39,36,40,W,W,W,W,W,L,-47,-39,-8,-4,32
586,2016-04-30,Bayern Munich,M'gladbach,1,1,D,1,1,14,47,79,49,W,W,W,L,W,L,-13,-46,33,30,32
587,2016-04-30,Darmstadt,Ein Frankfurt,1,2,A,1,2,49,50,34,32,L,W,W,L,W,L,-48,-48,0,2,32
588,2016-04-30,Dortmund,Wolfsburg,5,1,H,5,1,31,47,74,38,W,L,W,L,D,D,-26,-46,20,36,32
589,2016-04-30,Hannover,Schalke 04,1,3,A,1,3,58,46,22,47,D,L,W,L,D,D,-57,-43,-14,-25,32
590,2016-04-30,Hoffenheim,Ingolstadt,2,1,H,2,1,47,33,37,40,L,D,W,L,W,W,-45,-32,-13,-3,32
591,2016-04-30,Leverkusen,Hertha,2,1,H,2,1,36,39,54,48,W,L,W,L,W,D,-34,-38,4,6,32
592,2016-04-30,Mainz,Hamburg,0,0,D,0,0,40,42,43,35,L,W,L,L,D,L,-40,-42,2,8,32
593,2016-05-02,Werder Bremen,Stuttgart,6,2,H,6,2,64,66,33,33,L,L,W,L,L,L,-58,-64,6,0,32
594,2016-05-07,Ein Frankfurt,Dortmund,1,0,H,1,0,50,32,35,74,W,W,W,W,L,W,-49,-32,-17,-39,33
595,2016-05-07,FC Koln,Werder Bremen,0,0,D,0,0,39,64,41,34,D,W,W,L,W,W,-39,-64,25,7,33
596,2016-05-07,Hamburg,Wolfsburg,0,1,A,0,1,43,47,35,41,D,L,W,L,L,L,-43,-46,3,-6,33
597,2016-05-07,Hannover,Hoffenheim,1,0,H,1,0,58,48,25,37,L,W,D,L,W,W,-57,-48,-9,-12,33
598,2016-05-07,Hertha,Darmstadt,1,2,A,1,2,41,50,48,37,L,L,L,L,L,W,-40,-48,8,11,33
599,2016-05-07,Ingolstadt,Bayern Munich,1,2,A,1,2,35,15,40,82,L,D,D,W,L,W,-34,-13,-21,-42,33
600,2016-05-07,M'gladbach,Leverkusen,2,1,H,2,1,48,38,52,54,D,W,W,W,L,W,-46,-37,-9,-2,33
601,2016-05-07,Schalke 04,Augsburg,1,1,D,1,1,47,48,48,37,W,D,L,W,L,W,-46,-47,1,11,33
602,2016-05-07,Stuttgart,Mainz,1,3,A,1,3,69,41,33,46,L,D,L,L,L,L,-68,-38,-30,-13,33
603,2016-05-14,Augsburg,Hamburg,1,3,A,1,3,51,44,37,38,D,L,D,D,W,W,-50,-41,-9,-1,34
604,2016-05-14,Bayern Munich,Hannover,3,1,H,3,1,16,61,85,25,W,W,D,L,W,D,-13,-60,47,60,34
605,2016-05-14,Darmstadt,M'gladbach,0,2,A,0,2,52,48,37,55,W,W,L,D,L,W,-52,-46,-6,-18,34
606,2016-05-14,Dortmund,FC Koln,2,2,D,2,2,34,41,75,42,L,D,W,D,W,W,-32,-39,7,33,34
607,2016-05-14,Hoffenheim,Schalke 04,1,4,A,1,4,52,48,37,51,L,D,W,W,L,L,-51,-44,-7,-14,34
608,2016-05-14,Leverkusen,Ingolstadt,3,2,H,3,2,40,38,57,40,L,L,W,L,W,D,-37,-36,-1,17,34
609,2016-05-14,Mainz,Hertha,0,0,D,0,0,41,41,47,49,W,L,D,L,L,L,-41,-41,0,-2,34
610,2016-05-14,Werder Bremen,Ein Frankfurt,1,0,H,1,0,64,51,37,35,D,W,W,W,L,W,-63,-51,-12,2,34
611,2016-05-14,Wolfsburg,Stuttgart,3,1,H,3,1,48,72,44,33,W,L,L,L,L,L,-45,-71,26,11,34
612,2014-08-22,Bayern Munich,Wolfsburg,2,1,H,0,0,0,0,0,0,M,M,M,M,M,M,0,0,0,0,1
613,2014-08-23,Dortmund,Leverkusen,0,2,A,0,0,0,0,0,0,M,M,M,M,M,M,0,0,0,0,1
614,2014-08-23,Ein Frankfurt,Freiburg,1,0,H,0,0,0,0,0,0,M,M,M,M,M,M,0,0,0,0,1
615,2014-08-23,FC Koln,Hamburg,0,0,D,0,0,0,0,0,0,M,M,M,M,M,M,0,0,0,0,1
616,2014-08-23,Hannover,Schalke 04,2,1,H,0,0,0,0,0,0,M,M,M,M,M,M,0,0,0,0,1
617,2014-08-23,Hertha,Werder Bremen,2,2,D,0,0,0,0,0,0,M,M,M,M,M,M,0,0,0,0,1
618,2014-08-23,Hoffenheim,Augsburg,2,0,H,0,0,0,0,0,0,M,M,M,M,M,M,0,0,0,0,1
619,2014-08-24,M'gladbach,Stuttgart,1,1,D,0,0,0,0,0,0,M,M,M,M,M,M,0,0,0,0,1
620,2014-08-24,Paderborn,Mainz,2,2,D,0,0,0,0,0,0,M,M,M,M,M,M,0,0,0,0,1
621,2014-08-29,Augsburg,Dortmund,2,3,A,0,0,2,2,0,0,M,M,M,M,M,M,-2,-2,0,0,2
622,2014-08-30,Hamburg,Paderborn,0,3,A,0,2,0,2,1,1,M,M,M,M,M,M,0,0,0,0,2
623,2014-08-30,Leverkusen,Hertha,4,2,H,2,2,0,2,3,1,M,M,M,M,M,M,2,0,2,2,2
624,2014-08-30,Schalke 04,Bayern Munich,1,1,D,1,2,2,1,0,3,M,M,M,M,M,M,-1,1,-2,-3,2
625,2014-08-30,Stuttgart,FC Koln,0,2,A,1,0,1,0,1,1,M,M,M,M,M,M,0,0,0,0,2
626,2014-08-30,Werder Bremen,Hoffenheim,1,1,D,2,2,2,0,1,3,M,M,M,M,M,M,0,2,-2,-2,2
627,2014-08-30,Wolfsburg,Ein Frankfurt,2,2,D,1,1,2,0,0,3,M,M,M,M,M,M,-1,1,-2,-3,2
628,2014-08-31,Freiburg,M'gladbach,0,0,D,0,1,1,1,0,1,M,M,M,M,M,M,-1,0,-1,-1,2
629,2014-08-31,Mainz,Hannover,0,0,D,2,2,2,1,1,3,M,M,M,M,M,M,0,1,-1,-2,2
630,2014-09-12,Leverkusen,Werder Bremen,3,3,D,5,5,3,5,4,2,W,D,M,M,M,M,2,0,2,2,3
631,2014-09-13,Bayern Munich,Stuttgart,2,0,H,4,1,1,3,6,1,D,L,M,M,M,M,3,-2,5,5,3
632,2014-09-13,Dortmund,Freiburg,3,1,H,3,1,3,4,3,0,W,D,M,M,M,M,0,-3,3,3,3
633,2014-09-13,Hertha,Mainz,1,3,A,3,5,5,3,1,4,L,D,M,M,M,M,-2,2,-4,-3,3
634,2014-09-13,Hoffenheim,Wolfsburg,1,1,D,3,2,1,3,4,1,D,D,M,M,M,M,2,-1,3,3,3
635,2014-09-13,M'gladbach,Schalke 04,4,1,H,5,2,2,6,4,0,D,D,M,M,M,M,3,-4,7,4,3
636,2014-09-13,Paderborn,FC Koln,0,0,D,2,0,2,0,2,2,W,W,M,M,M,M,0,0,0,0,3
637,2014-09-14,Ein Frankfurt,Augsburg,0,1,A,1,1,1,2,3,3,D,L,M,M,M,M,0,-1,1,0,3
638,2014-09-14,Hannover,Hamburg,2,0,H,4,0,1,2,6,1,D,L,M,M,M,M,3,-2,5,5,3
639,2014-09-19,Freiburg,Hertha,2,2,D,3,5,6,7,1,2,L,L,D,L,M,M,-3,-2,-1,-1,4
640,2014-09-20,Augsburg,Werder Bremen,4,2,H,5,7,4,9,6,2,W,D,L,D,M,M,1,-2,3,4,4
641,2014-09-20,Hamburg,Bayern Munich,0,0,D,0,4,2,1,2,7,L,W,L,D,M,M,-2,3,-5,-5,4
642,2014-09-20,Mainz,Dortmund,2,0,H,7,3,3,5,7,3,W,W,D,W,M,M,4,-2,6,4,4
643,2014-09-20,Paderborn,Hannover,2,0,H,4,4,2,3,5,6,D,W,W,D,M,M,2,1,1,-1,4
644,2014-09-20,Schalke 04,Ein Frankfurt,2,2,D,4,3,8,3,1,4,L,L,D,D,M,M,-4,0,-4,-3,4
645,2014-09-20,Stuttgart,Hoffenheim,0,2,A,1,5,5,1,1,7,L,D,L,D,M,M,-4,4,-8,-6,4
646,2014-09-21,FC Koln,M'gladbach,0,0,D,0,5,0,2,3,5,D,W,W,D,M,M,0,3,-3,-2,4
647,2014-09-21,Wolfsburg,Leverkusen,4,1,H,6,6,4,7,4,4,D,D,D,W,M,M,2,-1,3,0,4
648,2014-09-23,Bayern Munich,Paderborn,4,0,H,8,4,1,6,10,5,D,W,W,D,D,W,7,-2,9,5,5
649,2014-09-23,Ein Frankfurt,Mainz,2,2,D,5,9,5,5,5,8,D,W,L,W,D,D,0,4,-4,-3,5
650,2014-09-23,Hoffenheim,Freiburg,3,3,D,8,6,4,9,8,2,W,D,D,L,D,D,4,-3,7,6,5
651,2014-09-23,Werder Bremen,Schalke 04,0,3,A,7,7,12,8,2,4,L,D,D,L,D,D,-5,-1,-4,-2,5
652,2014-09-24,Dortmund,Stuttgart,2,2,D,5,3,7,7,4,2,L,L,W,L,W,L,-2,-4,2,2,5
653,2014-09-24,Hannover,FC Koln,1,0,H,5,0,3,1,9,3,L,D,W,D,D,W,2,-1,3,6,5
654,2014-09-24,Hertha,Wolfsburg,1,0,H,6,6,7,5,5,4,D,W,L,D,L,D,-1,1,-2,1,5
655,2014-09-24,Leverkusen,Augsburg,1,0,H,7,5,7,5,7,6,L,W,D,W,W,L,0,0,0,1,5
656,2014-09-24,M'gladbach,Hamburg,1,0,H,6,0,2,3,8,2,D,D,W,L,D,L,4,-3,7,6,5
657,2014-09-26,Mainz,Hoffenheim,0,0,D,9,8,5,4,9,9,D,D,W,W,W,D,4,4,0,0,6
658,2014-09-27,FC Koln,Bayern Munich,0,2,A,0,10,3,1,3,13,L,W,D,D,D,W,-3,9,-12,-10,6
659,2014-09-27,Freiburg,Leverkusen,0,0,D,6,7,9,7,3,8,D,W,D,L,L,D,-3,0,-3,-5,6
660,2014-09-27,Paderborn,M'gladbach,1,2,A,5,8,8,3,5,11,L,W,W,D,D,W,-3,5,-8,-6,6
661,2014-09-27,Schalke 04,Dortmund,2,1,H,9,6,9,9,7,4,W,D,D,L,L,W,0,-3,3,3,6
662,2014-09-27,Stuttgart,Hannover,1,0,H,4,5,7,4,5,9,D,W,L,L,L,W,-3,1,-4,-4,6
663,2014-09-27,Wolfsburg,Werder Bremen,2,1,H,8,8,6,14,7,2,L,L,W,L,D,D,2,-6,8,5,6
664,2014-09-28,Augsburg,Hertha,1,0,H,6,6,5,8,9,5,L,W,W,D,W,L,1,-2,3,4,6
665,2014-09-28,Hamburg,Ein Frankfurt,1,2,A,1,7,5,6,2,8,L,D,D,D,L,L,-4,1,-5,-6,6
666,2014-10-03,Hertha,Stuttgart,3,2,H,9,6,10,10,8,5,L,W,W,D,D,L,-1,-4,3,3,7
667,2014-10-04,Bayern Munich,Hannover,4,0,H,14,5,1,8,16,9,W,L,W,W,D,L,13,-3,16,7,7
668,2014-10-04,Dortmund,Hamburg,0,1,A,6,2,10,5,4,5,L,L,D,L,L,D,-4,-3,-1,-1,7
669,2014-10-04,Ein Frankfurt,FC Koln,3,2,H,10,2,8,6,11,3,W,L,D,L,D,D,2,-4,6,8,7
670,2014-10-04,Hoffenheim,Schalke 04,2,1,H,10,10,5,11,12,7,D,W,D,W,W,D,5,-1,6,5,7
671,2014-10-04,Leverkusen,Paderborn,2,2,D,9,7,9,10,9,6,D,L,W,L,L,W,0,-3,3,3,7
672,2014-10-04,Werder Bremen,Freiburg,1,1,D,9,7,15,10,3,4,L,D,L,D,L,D,-6,-3,-3,-1,7
673,2014-10-05,M'gladbach,Mainz,1,1,D,9,10,4,6,12,10,W,D,W,D,D,W,5,4,1,2,7
674,2014-10-05,Wolfsburg,Augsburg,1,0,H,9,6,6,6,10,9,W,W,L,L,W,W,3,0,3,1,7
675,2014-10-18,Bayern Munich,Werder Bremen,6,0,H,20,9,1,21,19,3,W,D,W,L,W,L,19,-12,31,16,8
676,2014-10-18,FC Koln,Dortmund,2,1,H,4,7,7,12,6,4,L,L,L,L,L,D,-3,-5,2,2,8
677,2014-10-18,Freiburg,Wolfsburg,1,2,A,8,11,12,7,4,13,D,W,D,W,D,L,-4,4,-8,-9,8
678,2014-10-18,Hannover,M'gladbach,0,3,A,5,12,11,4,9,15,L,D,L,W,W,W,-6,8,-14,-6,8
679,2014-10-18,Mainz,Augsburg,2,1,H,12,7,7,8,13,9,D,L,D,W,D,L,5,-1,6,4,8
680,2014-10-18,Schalke 04,Hertha,2,0,H,12,9,11,12,10,8,L,W,W,L,W,W,1,-3,4,2,8
681,2014-10-18,Stuttgart,Leverkusen,3,3,D,9,12,13,12,6,10,L,D,W,D,D,W,-4,0,-4,-4,8
682,2014-10-19,Hamburg,Hoffenheim,1,1,D,3,11,6,6,6,13,W,W,L,D,L,D,-3,5,-8,-7,8
683,2014-10-19,Paderborn,Ein Frankfurt,3,1,H,10,11,11,11,9,11,D,W,L,W,L,D,-1,0,-1,-2,8
684,2014-10-24,Werder Bremen,FC Koln,0,1,A,9,5,22,7,3,9,L,W,D,L,L,L,-13,-2,-11,-6,9
685,2014-10-25,Augsburg,Freiburg,2,0,H,9,8,8,14,12,4,L,L,L,D,W,D,1,-6,7,8,9
686,2014-10-25,Dortmund,Hannover,0,1,A,7,6,13,11,4,12,L,L,L,L,L,L,-6,-5,-1,-8,9
687,2014-10-25,Ein Frankfurt,Stuttgart,4,5,A,15,14,16,17,11,9,L,D,W,L,W,W,-1,-3,2,2,9
688,2014-10-25,Hertha,Hamburg,3,0,H,12,3,12,9,11,6,L,D,W,W,L,L,0,-6,6,5,9
689,2014-10-25,Hoffenheim,Paderborn,1,0,H,12,10,6,12,16,9,D,W,W,D,D,L,6,-2,8,7,9
690,2014-10-25,Leverkusen,Schalke 04,1,0,H,13,12,12,12,13,10,D,W,D,L,D,W,1,0,1,3,9
691,2014-10-26,M'gladbach,Bayern Munich,0,0,D,12,20,4,1,16,20,W,W,D,W,W,W,8,19,-11,-4,9
692,2014-10-26,Wolfsburg,Mainz,3,0,H,14,12,7,10,16,13,W,W,W,D,W,D,7,2,5,3,9
693,2014-10-31,Schalke 04,Augsburg,1,0,H,13,9,12,9,13,12,L,W,W,L,L,L,1,0,1,1,10
694,2014-11-01,Bayern Munich,Dortmund,2,1,H,22,8,2,15,23,4,D,L,W,L,W,L,20,-7,27,19,10
695,2014-11-01,Hamburg,Leverkusen,1,0,H,4,13,9,13,9,13,L,W,D,D,W,D,-5,0,-5,-4,10
696,2014-11-01,Hannover,Ein Frankfurt,1,0,H,7,15,11,17,15,11,W,L,L,L,L,W,-4,-2,-2,4,10
697,2014-11-01,Mainz,Werder Bremen,1,2,A,13,11,12,23,13,6,L,L,W,L,D,D,1,-12,13,7,10
698,2014-11-01,Stuttgart,Wolfsburg,0,4,A,14,18,21,7,9,19,W,W,D,W,L,W,-7,11,-18,-10,10
699,2014-11-02,FC Koln,Freiburg,0,1,A,5,9,8,14,9,7,W,L,W,L,L,D,-3,-5,2,2,10
700,2014-11-02,M'gladbach,Hoffenheim,3,1,H,15,13,5,9,19,16,D,W,W,D,D,W,10,4,6,3,10
701,2014-11-02,Paderborn,Hertha,3,1,H,13,13,13,15,12,11,L,W,W,L,D,W,0,-2,2,1,10
702,2014-11-07,Hertha,Hannover,0,2,A,13,9,17,11,11,18,L,W,W,W,L,L,-4,-2,-2,-7,11
703,2014-11-08,Augsburg,Paderborn,3,0,H,12,13,9,16,15,12,L,W,W,L,L,W,3,-3,6,3,11
704,2014-11-08,Ein Frankfurt,Bayern Munich,0,4,A,15,26,21,2,11,26,L,W,L,D,L,W,-6,24,-30,-15,11
705,2014-11-08,Freiburg,Schalke 04,2,0,H,11,13,14,14,10,13,W,W,L,L,L,W,-3,-1,-2,-3,11
706,2014-11-08,Hoffenheim,FC Koln,3,4,A,16,9,13,11,16,12,L,L,W,W,D,W,3,-2,5,4,11
707,2014-11-08,Leverkusen,Mainz,0,0,D,13,13,13,12,14,14,L,L,W,L,D,W,0,1,-1,0,11
708,2014-11-08,Werder Bremen,Stuttgart,2,0,H,13,14,23,23,9,9,W,L,L,W,L,D,-10,-9,-1,0,11
709,2014-11-09,Dortmund,M'gladbach,1,0,H,9,15,15,6,7,19,L,W,L,D,L,W,-6,9,-15,-12,11
710,2014-11-09,Wolfsburg,Hamburg,2,0,H,20,4,7,11,22,9,W,W,W,L,W,D,13,-7,20,13,11
711,2014-11-22,Bayern Munich,Hoffenheim,4,0,H,30,16,2,17,29,16,W,L,W,L,D,W,28,-1,29,13,12
712,2014-11-22,FC Koln,Hertha,1,2,A,10,15,13,18,12,14,W,L,L,L,W,W,-3,-3,0,-2,12
713,2014-11-22,Hannover,Leverkusen,1,3,A,10,16,14,14,18,17,W,D,W,L,W,W,-4,2,-6,1,12
714,2014-11-22,Mainz,Freiburg,2,2,D,15,13,14,16,15,11,D,W,L,W,L,L,1,-3,4,4,12
715,2014-11-22,M'gladbach,Ein Frankfurt,1,3,A,16,18,9,22,19,14,L,L,W,L,D,L,7,-4,11,5,12
716,2014-11-22,Paderborn,Dortmund,2,2,D,15,11,18,17,13,8,L,W,W,L,L,L,-3,-6,3,5,12
717,2014-11-22,Schalke 04,Wolfsburg,3,2,H,16,22,16,10,16,22,L,W,W,W,L,W,0,12,-12,-6,12
718,2014-11-23,Hamburg,Werder Bremen,2,0,H,6,13,11,25,12,9,L,W,W,W,L,L,-5,-12,7,3,12
719,2014-11-23,Stuttgart,Augsburg,0,1,A,14,13,24,9,9,18,L,W,L,L,W,W,-10,4,-14,-9,12
720,2014-11-28,Freiburg,Stuttgart,1,4,A,14,18,20,25,11,12,D,L,W,L,W,L,-6,-7,1,-1,13
721,2014-11-29,Augsburg,Hamburg,3,1,H,16,7,10,14,21,12,W,W,W,L,L,W,6,-7,13,9,13
722,2014-11-29,Hertha,Bayern Munich,0,1,A,15,31,19,2,14,32,W,W,L,W,L,W,-4,29,-33,-18,13
723,2014-11-29,Hoffenheim,Hannover,4,3,H,20,13,20,18,19,18,L,L,L,W,L,W,0,-5,5,1,13
724,2014-11-29,Leverkusen,FC Koln,5,1,H,21,11,15,18,20,12,W,L,D,W,L,L,6,-7,13,8,13
725,2014-11-29,Schalke 04,Mainz,4,1,H,20,16,17,18,19,15,W,D,L,D,W,L,3,-2,5,4,13
726,2014-11-29,Werder Bremen,Paderborn,4,0,H,17,15,25,22,12,13,L,D,W,L,W,W,-8,-7,-1,-1,13
727,2014-11-30,Ein Frankfurt,Dortmund,2,0,H,20,11,22,19,17,8,W,D,L,W,L,L,-2,-8,6,9,13
728,2014-11-30,Wolfsburg,M'gladbach,1,0,H,23,16,10,10,25,19,L,L,W,L,W,W,13,6,7,6,13
729,2014-12-05,Dortmund,Hoffenheim,1,0,H,12,20,19,21,11,19,L,W,D,L,W,L,-7,-1,-6,-8,14
730,2014-12-06,Bayern Munich,Leverkusen,1,0,H,32,21,2,16,35,20,W,W,W,W,W,D,30,5,25,15,14
731,2014-12-06,FC Koln,Augsburg,1,2,A,12,18,20,11,12,24,L,W,L,W,W,W,-8,7,-15,-12,14
732,2014-12-06,Hannover,Wolfsburg,1,3,A,14,26,21,11,18,28,L,W,L,L,W,W,-7,15,-22,-10,14
733,2014-12-06,M'gladbach,Hertha,3,2,H,19,17,12,22,22,14,L,L,L,W,L,L,7,-5,12,8,14
734,2014-12-06,Paderborn,Freiburg,1,1,D,16,15,23,21,14,12,L,L,D,D,L,W,-7,-6,-1,2,14
735,2014-12-06,Stuttgart,Schalke 04,0,4,A,18,24,29,17,12,22,W,W,L,W,L,L,-11,7,-18,-10,14
736,2014-12-07,Ein Frankfurt,Werder Bremen,5,2,H,25,19,24,30,20,12,W,W,W,L,L,W,1,-11,12,8,14
737,2014-12-07,Hamburg,Mainz,2,1,H,9,17,15,20,15,15,L,L,W,D,L,D,-6,-3,-3,0,14
738,2014-12-12,Hoffenheim,Ein Frankfurt,3,2,H,23,27,23,27,22,20,L,W,W,W,L,W,0,0,0,2,15
739,2014-12-13,Augsburg,Bayern Munich,0,4,A,18,36,15,2,24,38,W,W,W,W,W,W,3,34,-31,-14,15
740,2014-12-13,Freiburg,Hamburg,0,0,D,15,9,21,15,13,16,D,W,L,L,D,W,-6,-6,0,-3,15
741,2014-12-13,Hertha,Dortmund,1,0,H,18,12,22,20,17,11,L,W,L,L,W,D,-4,-8,4,6,15
742,2014-12-13,Mainz,Stuttgart,1,1,D,18,19,21,30,16,13,L,L,L,W,D,L,-3,-11,8,3,15
743,2014-12-13,Schalke 04,FC Koln,1,2,A,25,14,19,21,22,15,W,L,W,L,W,L,6,-7,13,7,15
744,2014-12-13,Werder Bremen,Hannover,3,3,D,22,17,33,24,13,19,L,L,W,L,L,L,-11,-7,-4,-6,15
745,2014-12-14,Leverkusen,M'gladbach,1,1,D,22,20,17,13,21,23,L,W,W,L,W,L,5,7,-2,-2,15
746,2014-12-14,Wolfsburg,Paderborn,1,1,D,27,17,12,24,29,15,W,D,W,L,L,D,15,-7,22,14,15
747,2014-12-16,Bayern Munich,Freiburg,2,0,H,38,15,2,23,41,13,W,D,W,D,W,L,36,-8,44,28,16
748,2014-12-16,FC Koln,Mainz,0,0,D,14,18,21,21,16,17,W,D,L,L,L,L,-7,-3,-4,-1,16
749,2014-12-16,Hamburg,Stuttgart,0,1,A,9,20,16,30,16,16,D,D,W,L,L,W,-7,-10,3,0,16
750,2014-12-16,Hannover,Augsburg,2,0,H,19,18,24,17,22,24,D,L,L,W,L,W,-5,1,-6,-2,16
751,2014-12-17,Dortmund,Wolfsburg,2,2,D,14,29,22,14,12,30,L,D,W,W,L,W,-8,15,-23,-18,16
752,2014-12-17,Ein Frankfurt,Hertha,4,4,D,31,22,31,26,21,18,L,W,W,L,W,L,0,-4,4,3,16
753,2014-12-17,Hoffenheim,Leverkusen,0,1,A,23,23,24,17,22,24,W,D,L,L,W,W,-1,6,-7,-2,16
754,2014-12-17,M'gladbach,Werder Bremen,4,1,H,24,23,14,37,26,13,D,D,W,L,L,W,10,-14,24,13,16
755,2014-12-17,Paderborn,Schalke 04,1,2,A,18,27,26,20,15,25,D,L,D,W,L,W,-8,7,-15,-10,16
756,2014-12-19,Mainz,Bayern Munich,1,2,A,19,40,23,3,17,44,D,W,D,W,L,W,-4,37,-41,-27,17
757,2014-12-20,Augsburg,M'gladbach,2,1,H,20,25,18,16,27,26,L,W,L,D,W,W,2,9,-7,1,17
758,2014-12-20,Leverkusen,Ein Frankfurt,1,1,D,24,32,18,32,25,22,W,D,D,L,L,W,6,0,6,3,17
759,2014-12-20,Schalke 04,Hamburg,0,0,D,27,9,20,16,26,17,W,L,L,D,W,W,7,-7,14,9,17
760,2014-12-20,Stuttgart,Paderborn,0,0,D,20,18,30,26,17,16,W,L,D,D,L,D,-10,-8,-2,1,17
761,2014-12-20,Werder Bremen,Dortmund,2,1,H,25,15,38,24,16,12,L,D,D,L,L,W,-13,-9,-4,4,17
762,2014-12-20,Wolfsburg,FC Koln,2,1,H,31,15,15,23,33,16,D,D,D,W,W,L,16,-8,24,17,17
763,2014-12-21,Freiburg,Hannover,2,2,D,17,21,25,26,14,23,L,W,D,D,D,L,-8,-5,-3,-9,17
764,2014-12-21,Hertha,Hoffenheim,0,5,A,22,28,31,24,18,25,D,L,W,W,L,L,-9,4,-13,-7,17
765,2015-01-30,Wolfsburg,Bayern Munich,4,1,H,35,41,16,7,36,44,W,W,D,W,D,W,19,34,-15,-8,18
766,2015-01-31,Freiburg,Ein Frankfurt,4,1,H,21,33,26,36,17,22,D,D,L,D,D,L,-5,-3,-2,-5,18
767,2015-01-31,Hamburg,FC Koln,0,2,A,9,17,18,23,17,19,D,L,L,D,D,W,-9,-6,-3,-2,18
768,2015-01-31,Leverkusen,Dortmund,0,0,D,24,15,18,24,26,13,D,L,W,D,D,L,6,-9,15,13,18
769,2015-01-31,Mainz,Paderborn,5,0,H,24,18,23,31,20,16,L,D,D,L,D,D,1,-13,14,4,18
770,2015-01-31,Schalke 04,Hannover,1,0,H,28,21,20,27,29,23,D,D,W,W,L,D,8,-6,14,6,18
771,2015-01-31,Stuttgart,M'gladbach,0,1,A,20,26,31,16,17,29,D,L,W,W,D,D,-11,10,-21,-12,18
772,2015-02-01,Augsburg,Hoffenheim,3,1,H,23,29,19,27,30,25,W,W,L,L,L,W,4,2,2,5,18
773,2015-02-01,Werder Bremen,Hertha,2,0,H,27,22,38,33,19,18,W,L,L,D,D,W,-11,-11,0,1,18
774,2015-02-03,Bayern Munich,Schalke 04,1,1,D,42,29,8,21,45,30,L,W,W,D,W,W,34,8,26,15,19
775,2015-02-03,Ein Frankfurt,Wolfsburg,1,1,D,34,36,37,17,23,37,L,W,D,W,D,D,-3,19,-22,-14,19
776,2015-02-03,Hannover,Mainz,1,1,D,22,25,28,24,24,21,L,W,D,L,W,D,-6,1,-7,3,19
777,2015-02-03,M'gladbach,Freiburg,1,0,H,27,21,16,27,32,17,W,W,L,D,W,L,11,-6,17,15,19
778,2015-02-04,Dortmund,Augsburg,0,1,A,15,24,25,19,13,33,D,W,L,W,D,L,-10,5,-15,-20,19
779,2015-02-04,FC Koln,Stuttgart,0,0,D,17,20,23,31,20,18,W,L,L,D,D,W,-6,-11,5,2,19
780,2015-02-04,Hertha,Leverkusen,0,1,A,22,25,34,18,18,29,L,D,L,D,D,W,-12,7,-19,-11,19
781,2015-02-04,Hoffenheim,Werder Bremen,1,2,A,30,29,29,39,25,22,L,W,W,W,L,L,1,-10,11,3,19
782,2015-02-04,Paderborn,Hamburg,0,3,A,18,12,34,18,16,20,L,L,D,D,L,L,-16,-6,-10,-4,19
783,2015-02-06,Schalke 04,M'gladbach,1,0,H,30,27,21,17,33,32,D,W,W,W,D,L,9,10,-1,1,20
784,2015-02-07,FC Koln,Paderborn,0,0,D,17,18,23,34,21,17,D,L,W,L,L,D,-6,-16,10,4,20
785,2015-02-07,Freiburg,Dortmund,0,3,A,21,18,30,25,17,16,L,L,W,D,D,L,-9,-7,-2,1,20
786,2015-02-07,Hamburg,Hannover,2,1,H,14,23,19,30,23,24,W,D,L,L,D,D,-5,-7,2,-1,20
787,2015-02-07,Mainz,Hertha,0,2,A,25,24,26,34,21,21,D,L,W,L,L,L,-1,-10,9,0,20
788,2015-02-07,Stuttgart,Bayern Munich,0,2,A,20,44,33,8,18,48,D,D,L,L,D,W,-13,36,-49,-30,20
789,2015-02-07,Wolfsburg,Hoffenheim,3,0,H,39,30,17,32,40,25,D,L,W,L,W,W,22,-2,24,15,20
790,2015-02-08,Augsburg,Ein Frankfurt,2,2,D,26,36,21,39,34,24,W,D,W,L,W,D,5,-3,8,10,20
791,2015-02-08,Werder Bremen,Leverkusen,2,1,H,31,26,40,20,25,29,W,W,W,D,W,D,-9,6,-15,-4,20
792,2015-02-13,Dortmund,Mainz,4,2,H,22,27,27,30,19,21,W,L,L,D,D,W,-5,-3,-2,-2,21
793,2015-02-14,Bayern Munich,Hamburg,8,0,H,52,14,8,27,51,23,W,W,D,W,L,L,44,-13,57,28,21
794,2015-02-14,Ein Frankfurt,Schalke 04,1,0,H,37,30,39,22,27,33,D,W,D,D,L,W,-2,8,-10,-6,21
795,2015-02-14,Hoffenheim,Stuttgart,2,1,H,32,21,33,35,28,18,L,L,L,D,L,L,-1,-14,13,10,21
796,2015-02-14,Leverkusen,Wolfsburg,4,5,A,30,44,25,21,29,43,L,W,W,D,D,W,5,23,-18,-14,21
797,2015-02-14,M'gladbach,FC Koln,1,0,H,28,17,17,24,35,21,L,D,W,D,W,W,11,-7,18,14,21
798,2015-02-14,Werder Bremen,Augsburg,3,2,H,34,28,42,24,28,34,W,D,W,W,W,W,-8,4,-12,-6,21
799,2015-02-15,Hannover,Paderborn,1,2,A,24,20,32,35,24,20,L,D,D,L,L,L,-8,-15,7,4,21
800,2015-02-15,Hertha,Freiburg,0,2,A,24,23,36,30,21,20,W,L,L,L,L,W,-12,-7,-5,1,21
801,2015-02-20,Stuttgart,Dortmund,2,3,A,2,3,38,29,18,22,L,W,L,W,D,L,-36,-26,-10,-4,22
802,2015-02-21,Augsburg,Leverkusen,2,2,D,2,2,26,27,35,30,L,L,D,L,W,W,-24,-25,1,5,22
803,2015-02-21,FC Koln,Hannover,1,1,D,1,1,25,33,22,25,L,L,D,L,D,D,-24,-32,8,-3,22
804,2015-02-21,Freiburg,Hoffenheim,1,1,D,1,1,31,34,21,29,W,W,L,L,L,L,-30,-33,3,-8,22
805,2015-02-21,Mainz,Ein Frankfurt,3,1,H,3,1,31,42,24,27,L,W,L,D,D,D,-28,-41,13,-3,22
806,2015-02-21,Paderborn,Bayern Munich,0,6,A,0,6,41,8,20,54,W,W,D,W,L,D,-41,-2,-39,-34,22
807,2015-02-21,Schalke 04,Werder Bremen,1,1,D,1,1,23,43,34,29,L,W,W,W,D,W,-22,-42,20,5,22
808,2015-02-22,Hamburg,M'gladbach,1,1,D,1,1,28,18,24,36,L,W,W,L,W,W,-27,-17,-10,-12,22
809,2015-02-22,Wolfsburg,Hertha,2,1,H,2,1,22,38,46,21,W,L,W,W,D,L,-20,-37,17,25,22
810,2015-02-27,Bayern Munich,FC Koln,4,1,H,4,1,9,29,57,22,W,D,W,L,W,D,-5,-28,23,35,23
811,2015-02-28,Dortmund,Schalke 04,3,0,H,3,0,29,26,25,34,W,D,W,L,W,W,-26,-26,0,-9,23
812,2015-02-28,Ein Frankfurt,Hamburg,2,1,H,2,1,43,30,30,24,L,D,W,L,D,W,-41,-29,-12,6,23
813,2015-02-28,Hannover,Stuttgart,1,1,D,1,1,34,39,26,19,D,L,L,L,L,L,-33,-38,5,7,23
814,2015-02-28,Hertha,Augsburg,1,0,H,1,0,38,27,24,35,L,D,L,L,W,D,-37,-27,-10,-11,23
815,2015-02-28,Hoffenheim,Mainz,2,0,H,2,0,34,33,32,24,D,W,W,L,L,L,-32,-33,1,8,23
816,2015-02-28,Leverkusen,Freiburg,1,0,H,1,0,27,32,33,21,D,D,L,W,L,L,-26,-32,6,12,23
817,2015-03-01,M'gladbach,Paderborn,2,0,H,2,0,18,43,39,20,D,L,W,W,L,D,-16,-43,27,19,23
818,2015-03-01,Werder Bremen,Wolfsburg,3,5,A,3,5,48,25,29,49,D,W,W,W,W,W,-45,-20,-25,-20,23
819,2015-03-06,Stuttgart,Hertha,0,0,D,0,0,39,38,20,25,D,W,L,L,L,L,-39,-38,-1,-5,24
820,2015-03-07,Augsburg,Wolfsburg,1,0,H,1,0,27,26,38,49,L,W,D,W,L,W,-26,-26,0,-11,24
821,2015-03-07,Freiburg,Werder Bremen,0,1,A,0,1,33,48,21,32,L,L,D,D,W,W,-33,-47,14,-11,24
822,2015-03-07,Hamburg,Dortmund,0,0,D,0,0,30,29,25,26,L,W,D,W,L,W,-30,-29,-1,-1,24
823,2015-03-07,Hannover,Bayern Munich,1,3,A,1,3,37,10,26,60,D,W,D,W,L,W,-36,-7,-29,-34,24
824,2015-03-07,Mainz,M'gladbach,2,2,D,2,2,35,20,25,40,L,W,W,D,L,W,-33,-18,-15,-15,24
825,2015-03-07,Schalke 04,Hoffenheim,3,1,H,3,1,27,37,37,32,L,W,D,D,L,W,-24,-36,12,5,24
826,2015-03-08,FC Koln,Ein Frankfurt,4,2,H,4,2,31,47,25,30,L,W,D,L,L,W,-27,-45,18,-5,24
827,2015-03-08,Paderborn,Leverkusen,0,3,A,0,3,46,27,20,36,L,W,L,D,W,L,-46,-24,-22,-16,24
828,2015-03-13,Leverkusen,Stuttgart,4,0,H,4,0,27,43,39,20,W,D,W,D,D,L,-23,-43,20,19,25
829,2015-03-14,Augsburg,Mainz,0,2,A,0,2,29,35,38,28,W,D,L,L,D,W,-29,-33,4,10,25
830,2015-03-14,Dortmund,FC Koln,0,0,D,0,0,29,31,27,26,D,W,W,L,W,D,-29,-31,2,1,25
831,2015-03-14,Ein Frankfurt,Paderborn,4,0,H,4,0,47,50,33,20,L,L,W,L,L,L,-43,-50,7,13,25
832,2015-03-14,Hertha,Schalke 04,2,2,D,2,2,40,29,26,38,D,W,W,L,L,D,-38,-27,-11,-12,25
833,2015-03-14,Hoffenheim,Hamburg,3,0,H,3,0,37,33,35,25,L,D,W,L,D,D,-34,-33,-1,10,25
834,2015-03-14,Werder Bremen,Bayern Munich,0,4,A,0,4,52,10,32,63,W,W,L,W,D,W,-52,-6,-46,-31,25
835,2015-03-15,M'gladbach,Hannover,2,0,H,2,0,20,39,43,26,D,L,W,D,D,D,-18,-39,21,17,25
836,2015-03-15,Wolfsburg,Freiburg,3,0,H,3,0,26,36,52,21,L,L,W,L,W,D,-23,-36,13,31,25
837,2015-03-20,Hamburg,Hertha,0,1,A,0,1,34,40,25,29,L,D,D,D,L,W,-34,-39,5,-4,26
838,2015-03-21,FC Koln,Werder Bremen,1,1,D,1,1,32,53,27,33,D,L,W,W,L,L,-31,-52,21,-6,26
839,2015-03-21,Freiburg,Augsburg,2,0,H,2,0,36,31,24,38,L,L,L,W,L,L,-34,-31,-3,-14,26
840,2015-03-21,Hannover,Dortmund,2,3,A,2,3,42,31,26,30,L,D,L,D,D,W,-40,-28,-12,-4,26
841,2015-03-21,Paderborn,Hoffenheim,0,0,D,0,0,50,37,21,36,L,W,L,L,L,W,-50,-37,-13,-15,26
842,2015-03-21,Schalke 04,Leverkusen,0,1,A,0,1,30,27,38,42,D,W,W,W,L,W,-30,-26,-4,-4,26
843,2015-03-21,Stuttgart,Ein Frankfurt,3,1,H,3,1,44,50,23,33,L,W,D,L,D,W,-41,-49,8,-10,26
844,2015-03-22,Bayern Munich,M'gladbach,0,2,A,0,2,12,20,63,46,W,W,W,D,W,W,-12,-18,6,17,26
845,2015-03-22,Mainz,Wolfsburg,1,1,D,1,1,36,27,29,53,W,W,D,L,L,W,-35,-26,-9,-24,26
846,2015-04-04,Dortmund,Bayern Munich,0,1,A,0,1,32,12,30,66,W,L,D,W,D,W,-32,-11,-21,-36,27
847,2015-04-04,Ein Frankfurt,Hannover,2,2,D,2,2,52,44,34,27,L,L,W,L,L,L,-50,-42,-8,7,27
848,2015-04-04,Freiburg,FC Koln,1,0,H,1,0,36,33,27,27,W,D,L,D,L,W,-35,-33,-2,0,27
849,2015-04-04,Hoffenheim,M'gladbach,1,4,A,1,4,41,21,36,49,D,W,W,W,L,D,-40,-17,-23,-13,27
850,2015-04-04,Leverkusen,Hamburg,4,0,H,4,0,27,38,45,25,W,L,W,L,W,D,-23,-38,15,20,27
851,2015-04-04,Werder Bremen,Mainz,0,0,D,0,0,53,36,34,30,D,D,L,W,W,D,-53,-36,-17,4,27
852,2015-04-04,Wolfsburg,Stuttgart,3,1,H,3,1,28,47,56,23,D,W,W,L,L,D,-25,-46,21,33,27
853,2015-04-05,Augsburg,Schalke 04,0,0,D,0,0,31,30,39,39,L,L,L,D,W,W,-31,-30,-1,0,27
854,2015-04-05,Hertha,Paderborn,2,0,H,2,0,40,52,32,21,W,D,D,L,D,L,-38,-52,14,11,27
855,2015-04-10,Hannover,Hertha,1,1,D,1,1,45,41,28,33,D,W,L,W,L,D,-44,-40,-4,-5,28
856,2015-04-11,Bayern Munich,Ein Frankfurt,3,0,H,3,0,12,55,69,34,W,D,L,L,W,W,-9,-55,46,35,28
857,2015-04-11,Hamburg,Wolfsburg,0,2,A,0,2,40,28,25,59,L,W,L,D,L,W,-40,-26,-14,-34,28
858,2015-04-11,Mainz,Leverkusen,2,3,A,2,3,39,29,30,48,D,W,D,W,W,W,-37,-26,-11,-18,28
859,2015-04-11,M'gladbach,Dortmund,3,1,H,3,1,22,35,52,30,W,L,W,W,W,D,-19,-34,15,22,28
860,2015-04-11,Paderborn,Augsburg,2,1,H,2,1,53,33,24,39,L,D,D,L,L,L,-51,-32,-19,-15,28
861,2015-04-11,Schalke 04,Freiburg,0,0,D,0,0,30,36,40,28,D,W,L,W,D,L,-30,-36,6,12,28
862,2015-04-12,FC Koln,Hoffenheim,3,2,H,3,2,35,44,30,36,L,L,D,D,D,W,-32,-42,10,-6,28
863,2015-04-12,Stuttgart,Werder Bremen,3,2,H,3,2,49,56,26,34,L,D,W,D,L,L,-46,-54,8,-8,28
864,2015-04-17,Ein Frankfurt,M'gladbach,0,0,D,0,0,55,22,35,53,L,W,D,W,L,W,-55,-22,-33,-18,29
865,2015-04-18,Augsburg,Stuttgart,2,1,H,2,1,34,51,42,26,L,W,D,L,L,W,-32,-50,18,16,29
866,2015-04-18,Dortmund,Paderborn,3,0,H,3,0,35,56,33,24,L,W,L,L,W,D,-32,-56,24,9,29
867,2015-04-18,Freiburg,Mainz,2,3,A,2,3,39,41,28,33,D,L,W,D,W,D,-37,-38,1,-5,29
868,2015-04-18,Hertha,FC Koln,0,0,D,0,0,41,35,34,31,D,W,W,L,W,D,-41,-35,-6,3,29
869,2015-04-18,Hoffenheim,Bayern Munich,0,2,A,0,2,46,12,36,72,L,W,L,W,D,L,-46,-10,-36,-36,29
870,2015-04-18,Leverkusen,Hannover,4,0,H,4,0,29,49,51,28,W,D,W,D,W,L,-25,-49,24,23,29
871,2015-04-19,Werder Bremen,Hamburg,1,0,H,1,0,56,41,37,25,L,L,D,L,D,L,-55,-41,-14,12,29
872,2015-04-19,Wolfsburg,Schalke 04,1,1,D,1,1,29,31,60,41,W,D,W,D,D,L,-28,-30,2,19,29
873,2015-04-24,Mainz,Schalke 04,2,0,H,2,0,41,33,36,41,W,D,L,D,D,D,-39,-33,-6,-5,30
874,2015-04-25,Bayern Munich,Hertha,1,0,H,1,0,12,42,75,34,W,D,W,D,W,W,-11,-42,31,41,30
875,2015-04-25,Dortmund,Ein Frankfurt,2,0,H,2,0,35,57,36,35,W,D,L,L,L,D,-33,-57,24,1,30
876,2015-04-25,FC Koln,Leverkusen,1,1,D,1,1,36,30,32,52,D,W,W,W,L,W,-35,-29,-6,-20,30
877,2015-04-25,Hamburg,Augsburg,3,2,H,3,2,43,37,28,42,L,W,L,L,L,D,-40,-35,-5,-14,30
878,2015-04-25,Hannover,Hoffenheim,1,2,A,1,2,51,47,28,39,L,L,D,L,D,L,-50,-45,-5,-11,30
879,2015-04-25,Stuttgart,Freiburg,2,2,D,2,2,53,41,27,29,L,L,W,D,L,W,-51,-39,-12,-2,30
880,2015-04-26,M'gladbach,Wolfsburg,1,0,H,1,0,22,30,56,60,D,D,W,W,W,W,-21,-30,9,-4,30
881,2015-04-26,Paderborn,Werder Bremen,2,2,D,2,2,58,58,25,38,L,W,W,L,L,D,-56,-56,0,-13,30
882,2015-05-02,Augsburg,FC Koln,0,0,D,0,0,37,36,43,33,L,D,W,D,L,W,-37,-36,-1,10,31
883,2015-05-02,Freiburg,Paderborn,1,2,A,1,2,43,59,29,28,D,D,L,L,D,W,-42,-57,15,1,31
884,2015-05-02,Hoffenheim,Dortmund,1,1,D,1,1,48,36,40,37,W,W,L,W,L,L,-47,-35,-12,3,31
885,2015-05-02,Leverkusen,Bayern Munich,2,0,H,2,0,30,14,55,75,D,W,W,W,W,W,-28,-14,-14,-20,31
886,2015-05-02,Schalke 04,Stuttgart,3,2,H,3,2,35,56,44,27,L,D,D,L,D,W,-32,-54,22,17,31
887,2015-05-02,Werder Bremen,Ein Frankfurt,1,0,H,1,0,58,58,41,35,D,L,W,D,L,L,-57,-58,1,6,31
888,2015-05-02,Wolfsburg,Hannover,2,2,D,2,2,32,53,61,29,L,L,D,L,W,D,-30,-51,21,32,31
889,2015-05-03,Hertha,M'gladbach,1,2,A,1,2,44,23,34,59,L,W,D,D,D,W,-43,-21,-22,-25,31
890,2015-05-03,Mainz,Hamburg,1,2,A,1,2,43,44,36,31,W,W,W,L,L,L,-42,-42,0,5,31
891,2015-05-08,Hamburg,Freiburg,1,1,D,1,1,45,44,32,30,W,L,W,D,L,L,-44,-43,-1,2,32
892,2015-05-09,Bayern Munich,Augsburg,0,1,A,0,1,15,37,75,46,L,D,W,L,W,W,-15,-36,21,29,32
893,2015-05-09,Dortmund,Hertha,2,0,H,2,0,36,46,40,34,D,L,W,L,W,D,-34,-46,12,6,32
894,2015-05-09,Ein Frankfurt,Hoffenheim,3,1,H,3,1,59,51,38,40,L,D,L,W,D,L,-56,-50,-6,-2,32
895,2015-05-09,Hannover,Werder Bremen,1,1,D,1,1,54,59,30,42,D,W,L,D,L,W,-53,-58,5,-12,32
896,2015-05-09,M'gladbach,Leverkusen,3,0,H,3,0,23,33,62,55,W,W,W,D,D,W,-20,-33,13,7,32
897,2015-05-09,Stuttgart,Mainz,2,0,H,2,0,56,45,30,36,L,L,D,W,L,W,-54,-45,-9,-6,32
898,2015-05-10,FC Koln,Schalke 04,2,0,H,2,0,36,37,36,44,D,W,D,L,D,D,-34,-37,3,-8,32
899,2015-05-10,Paderborn,Wolfsburg,1,3,A,1,3,62,33,28,64,W,D,D,L,L,D,-61,-30,-31,-36,32
900,2015-05-16,Augsburg,Hannover,1,2,A,1,2,39,55,46,33,W,D,D,D,L,L,-38,-53,15,13,33
901,2015-05-16,Freiburg,Bayern Munich,2,1,H,2,1,45,17,33,75,D,L,L,L,D,W,-43,-16,-27,-42,33
902,2015-05-16,Hertha,Ein Frankfurt,0,0,D,0,0,46,59,35,39,L,W,L,L,L,L,-46,-59,13,-4,33
903,2015-05-16,Leverkusen,Hoffenheim,2,0,H,2,0,33,53,58,40,L,L,W,D,D,W,-31,-53,22,18,33
904,2015-05-16,Mainz,FC Koln,2,0,H,2,0,45,38,39,36,L,W,L,D,W,D,-43,-38,-5,3,33
905,2015-05-16,Schalke 04,Paderborn,1,0,H,1,0,37,63,47,28,L,L,W,W,L,D,-36,-63,27,19,33
906,2015-05-16,Stuttgart,Hamburg,2,1,H,2,1,57,47,33,32,W,D,L,W,D,W,-55,-46,-9,1,33
907,2015-05-16,Werder Bremen,M'gladbach,0,2,A,0,2,61,23,42,65,D,W,W,W,D,W,-61,-21,-40,-23,33
908,2015-05-16,Wolfsburg,Dortmund,2,1,H,2,1,34,38,67,40,W,W,D,D,L,W,-32,-37,5,27,33
909,2015-05-23,Bayern Munich,Mainz,2,0,H,2,0,17,47,78,39,L,W,L,L,L,L,-15,-47,32,39,34
910,2015-05-23,Dortmund,Werder Bremen,3,2,H,3,2,40,64,43,42,L,L,W,D,D,W,-37,-62,25,1,34
911,2015-05-23,Ein Frankfurt,Leverkusen,2,1,H,2,1,60,35,42,58,D,W,W,L,L,W,-58,-34,-24,-16,34
912,2015-05-23,FC Koln,Wolfsburg,2,2,D,2,2,40,36,37,68,L,W,W,W,D,D,-38,-34,-4,-31,34
913,2015-05-23,Hamburg,Schalke 04,2,0,H,2,0,47,39,35,47,L,W,D,L,W,W,-45,-39,-6,-12,34
914,2015-05-23,Hannover,Freiburg,2,1,H,2,1,56,47,36,33,W,W,D,D,D,L,-54,-46,-8,3,34
915,2015-05-23,Hoffenheim,Hertha,2,1,H,2,1,54,48,43,35,L,D,L,L,D,L,-52,-47,-5,8,34
916,2015-05-23,M'gladbach,Augsburg,1,3,A,1,3,26,40,65,49,W,L,W,W,W,D,-25,-37,12,16,34
917,2015-05-23,Paderborn,Stuttgart,1,2,A,1,2,65,58,28,36,L,W,L,W,W,L,-64,-56,-8,-8,34
918,2013-08-09,Bayern Munich,M'gladbach,3,1,H,0,0,0,0,0,0,M,M,M,M,M,M,0,0,0,0,1
919,2013-08-10,Augsburg,Dortmund,0,4,A,0,0,0,0,0,0,M,M,M,M,M,M,0,0,0,0,1
920,2013-08-10,Braunschweig,Werder Bremen,0,1,A,0,0,0,0,0,0,M,M,M,M,M,M,0,0,0,0,1
921,2013-08-10,Hannover,Wolfsburg,2,0,H,0,0,0,0,0,0,M,M,M,M,M,M,0,0,0,0,1
922,2013-08-10,Hertha,Ein Frankfurt,6,1,H,0,0,0,0,0,0,M,M,M,M,M,M,0,0,0,0,1
923,2013-08-10,Hoffenheim,Nurnberg,2,2,D,0,0,0,0,0,0,M,M,M,M,M,M,0,0,0,0,1
924,2013-08-10,Leverkusen,Freiburg,3,1,H,0,0,0,0,0,0,M,M,M,M,M,M,0,0,0,0,1
925,2013-08-11,Mainz,Stuttgart,3,2,H,0,0,0,0,0,0,M,M,M,M,M,M,0,0,0,0,1
926,2013-08-11,Schalke 04,Hamburg,3,3,D,0,0,0,0,0,0,M,M,M,M,M,M,0,0,0,0,1
927,2013-08-17,Ein Frankfurt,Bayern Munich,0,1,A,1,3,6,1,0,3,M,M,M,M,M,M,-5,2,-7,-3,2
928,2013-08-17,Freiburg,Mainz,1,2,A,1,3,3,2,0,3,M,M,M,M,M,M,-2,1,-3,-3,2
929,2013-08-17,Hamburg,Hoffenheim,1,5,A,3,2,3,2,1,1,M,M,M,M,M,M,0,0,0,0,2
930,2013-08-17,M'gladbach,Hannover,3,0,H,1,2,3,0,0,3,M,M,M,M,M,M,-2,2,-4,-3,2
931,2013-08-17,Stuttgart,Leverkusen,0,1,A,2,3,3,1,0,3,M,M,M,M,M,M,-1,2,-3,-3,2
932,2013-08-17,Werder Bremen,Augsburg,1,0,H,1,0,0,4,3,0,M,M,M,M,M,M,1,-4,5,3,2
933,2013-08-17,Wolfsburg,Schalke 04,4,0,H,0,3,2,3,0,1,M,M,M,M,M,M,-2,0,-2,-1,2
934,2013-08-18,Dortmund,Braunschweig,2,1,H,4,0,0,1,3,0,M,M,M,M,M,M,4,-1,5,3,2
935,2013-08-18,Nurnberg,Hertha,2,2,D,2,6,2,1,1,3,M,M,M,M,M,M,0,5,-5,-2,2
936,2013-08-23,Dortmund,Werder Bremen,1,0,H,5,1,0,1,6,3,W,W,M,M,M,M,5,0,5,3,3
937,2013-08-24,Bayern Munich,Nurnberg,2,0,H,5,2,1,4,6,1,W,D,M,M,M,M,4,-2,6,5,3
938,2013-08-24,Hannover,Schalke 04,2,1,H,4,4,1,5,6,1,L,L,M,M,M,M,3,-1,4,5,3
939,2013-08-24,Hertha,Hamburg,1,0,H,7,3,1,4,6,1,D,L,M,M,M,M,6,-1,7,5,3
940,2013-08-24,Hoffenheim,Freiburg,3,3,D,5,4,5,6,2,1,W,L,M,M,M,M,0,-2,2,1,3
941,2013-08-24,Leverkusen,M'gladbach,4,2,H,7,3,3,7,6,0,W,W,M,M,M,M,4,-4,8,6,3
942,2013-08-24,Mainz,Wolfsburg,2,0,H,5,0,2,4,6,0,W,W,M,M,M,M,3,-4,7,6,3
943,2013-08-25,Augsburg,Stuttgart,2,1,H,2,3,5,5,3,0,L,L,M,M,M,M,-3,-2,-1,3,3
944,2013-08-25,Braunschweig,Ein Frankfurt,0,2,A,0,3,3,6,0,3,L,L,M,M,M,M,-3,-3,0,-3,3
945,2013-08-27,Freiburg,Bayern Munich,1,1,D,5,6,7,2,2,7,D,W,L,W,M,M,-2,4,-6,-5,4
946,2013-08-31,Hamburg,Braunschweig,4,0,H,7,0,4,7,4,0,L,L,L,L,M,M,3,-7,10,4,4
947,2013-08-31,Hannover,Mainz,4,1,H,8,6,2,6,9,6,W,W,L,W,M,M,6,0,6,3,4
948,2013-08-31,M'gladbach,Werder Bremen,4,1,H,7,2,8,5,3,3,L,L,W,W,M,M,-1,-3,2,0,4
949,2013-08-31,Nurnberg,Augsburg,0,1,A,2,3,5,5,1,6,L,W,D,L,M,M,-3,-2,-1,-5,4
950,2013-08-31,Schalke 04,Leverkusen,2,0,H,6,7,5,5,4,6,L,W,L,W,M,M,1,2,-1,-2,4
951,2013-08-31,Wolfsburg,Hertha,2,0,H,2,7,4,3,3,6,L,W,W,D,M,M,-2,4,-6,-3,4
952,2013-09-01,Ein Frankfurt,Dortmund,1,2,A,4,7,8,1,3,9,W,W,L,W,M,M,-4,6,-10,-6,4
953,2013-09-01,Stuttgart,Hoffenheim,6,2,H,9,7,7,11,3,2,L,D,L,W,M,M,2,-4,6,1,4
954,2013-09-13,Hertha,Stuttgart,0,1,A,7,10,4,7,6,6,L,W,W,L,D,L,3,3,0,0,5
955,2013-09-14,Augsburg,Freiburg,2,1,H,5,6,6,9,9,2,W,D,W,D,L,L,-1,-3,2,7,5
956,2013-09-14,Bayern Munich,Hannover,2,0,H,8,8,2,4,10,9,D,W,W,W,W,L,6,4,2,1,5
957,2013-09-14,Dortmund,Hamburg,6,2,H,13,9,3,10,12,4,W,W,W,L,W,L,10,-1,11,8,5
958,2013-09-14,Leverkusen,Wolfsburg,3,1,H,10,3,6,7,9,3,L,W,W,L,W,W,4,-4,8,6,5
959,2013-09-14,Mainz,Schalke 04,0,1,A,6,7,7,5,6,7,L,W,W,L,W,L,-1,2,-3,-1,5
960,2013-09-14,Werder Bremen,Ein Frankfurt,0,3,A,2,7,8,8,3,6,L,L,L,W,W,L,-6,-1,-5,-3,5
961,2013-09-15,Braunschweig,Nurnberg,1,1,D,1,3,8,6,1,2,L,L,L,L,L,D,-7,-3,-4,-1,5
962,2013-09-15,Hoffenheim,M'gladbach,2,1,H,9,8,12,10,5,3,L,W,D,L,W,W,-3,-2,-1,2,5
963,2013-09-20,M'gladbach,Braunschweig,4,1,H,12,2,11,12,6,1,L,D,W,L,L,L,1,-10,11,5,6
964,2013-09-21,Hamburg,Werder Bremen,0,2,A,9,4,12,8,4,6,L,L,W,L,L,L,-3,-4,1,-2,6
965,2013-09-21,Hannover,Augsburg,2,1,H,10,6,5,8,12,9,L,W,W,W,W,W,5,-2,7,3,6
966,2013-09-21,Mainz,Leverkusen,1,4,A,7,14,11,7,6,12,L,W,L,L,W,W,-4,7,-11,-6,6
967,2013-09-21,Nurnberg,Dortmund,1,1,D,4,14,7,4,3,13,D,W,L,W,L,W,-3,10,-13,-10,6
968,2013-09-21,Schalke 04,Bayern Munich,0,4,A,7,12,9,2,7,13,W,W,W,D,L,W,-2,10,-12,-6,6
969,2013-09-21,Wolfsburg,Hoffenheim,2,1,H,5,10,8,14,6,5,L,W,W,L,L,D,-3,-4,1,1,6
970,2013-09-22,Freiburg,Hertha,1,1,D,7,8,10,5,3,7,L,L,D,L,D,W,-3,3,-6,-4,6
971,2013-09-22,Stuttgart,Ein Frankfurt,1,1,D,11,8,8,9,7,7,W,W,W,L,L,W,3,-1,4,0,6
972,2013-09-27,Augsburg,M'gladbach,2,2,D,8,14,10,13,10,7,L,W,W,L,W,W,-2,1,-3,3,7
973,2013-09-28,Bayern Munich,Wolfsburg,1,0,H,13,5,2,9,16,6,W,W,W,L,D,W,11,-4,15,10,7
974,2013-09-28,Dortmund,Freiburg,5,0,H,19,7,4,15,16,3,D,D,W,L,W,D,15,-8,23,13,7
975,2013-09-28,Ein Frankfurt,Hamburg,2,2,D,10,11,11,14,8,5,D,L,W,L,L,W,-1,-3,2,3,7
976,2013-09-28,Hertha,Mainz,3,1,H,11,8,6,14,10,6,D,L,L,L,L,L,5,-6,11,4,7
977,2013-09-28,Hoffenheim,Schalke 04,3,3,D,13,10,17,12,6,8,L,L,W,W,L,W,-4,-2,-2,-2,7
978,2013-09-28,Leverkusen,Hannover,2,0,H,16,10,7,7,15,12,W,W,W,L,L,W,9,3,6,3,7
979,2013-09-29,Braunschweig,Stuttgart,0,4,A,2,15,16,8,1,10,L,D,D,W,L,W,-14,7,-21,-9,7
980,2013-09-29,Werder Bremen,Nurnberg,3,3,D,7,7,11,10,7,4,W,D,L,D,L,L,-4,-3,-1,3,7
981,2013-10-04,Hannover,Hertha,1,1,D,11,12,8,7,13,11,L,W,W,D,L,L,3,5,-2,2,8
982,2013-10-05,Leverkusen,Bayern Munich,1,1,D,17,14,8,3,16,17,W,W,W,W,W,W,9,11,-2,-1,8
983,2013-10-05,Mainz,Hoffenheim,2,2,D,10,15,16,19,7,7,L,D,L,L,L,W,-6,-4,-2,0,8
984,2013-10-05,M'gladbach,Dortmund,2,0,H,16,19,13,6,10,16,D,W,W,D,L,W,3,13,-10,-6,8
985,2013-10-05,Schalke 04,Augsburg,4,1,H,14,9,13,14,11,10,D,D,L,L,W,W,1,-5,6,1,8
986,2013-10-05,Stuttgart,Werder Bremen,1,1,D,16,8,9,12,11,8,W,D,D,W,W,L,7,-4,11,3,8
987,2013-10-05,Wolfsburg,Braunschweig,0,2,A,5,4,11,16,6,4,L,L,W,L,L,D,-6,-12,6,2,8
988,2013-10-06,Freiburg,Ein Frankfurt,1,1,D,8,11,16,12,4,9,L,D,D,D,L,W,-8,-1,-7,-5,8
989,2013-10-06,Nurnberg,Hamburg,0,5,A,7,16,15,14,4,8,D,D,D,L,D,L,-8,2,-10,-4,8
990,2013-10-18,Hoffenheim,Leverkusen,1,2,A,16,19,21,9,7,19,D,D,D,W,L,W,-5,10,-15,-12,9
991,2013-10-19,Bayern Munich,Mainz,4,1,H,18,11,4,20,20,7,D,D,W,L,W,L,14,-9,23,13,9
992,2013-10-19,Braunschweig,Schalke 04,2,3,A,6,17,19,15,4,14,W,W,L,D,L,L,-13,2,-15,-10,9
993,2013-10-19,Dortmund,Hannover,1,0,H,20,11,6,9,19,13,L,D,W,L,D,W,14,2,12,6,9
994,2013-10-19,Ein Frankfurt,Nurnberg,1,1,D,12,8,13,16,10,5,D,L,D,D,D,D,-1,-8,7,5,9
995,2013-10-19,Hertha,M'gladbach,1,0,H,13,16,7,14,14,10,D,W,W,D,D,W,6,2,4,4,9
996,2013-10-19,Werder Bremen,Freiburg,0,0,D,8,8,12,16,9,5,D,D,D,L,W,D,-4,-8,4,4,9
997,2013-10-20,Augsburg,Wolfsburg,1,2,A,10,7,16,12,10,9,L,L,D,L,L,W,-6,-5,-1,1,9
998,2013-10-20,Hamburg,Stuttgart,3,3,D,19,19,17,12,9,12,W,D,D,W,L,D,2,7,-5,-3,9
999,2013-10-25,Stuttgart,Nurnberg,1,1,D,20,9,13,17,13,6,D,D,D,L,W,D,7,-8,15,7,10
1000,2013-10-26,Bayern Munich,Hertha,3,2,H,21,15,6,10,23,14,W,W,D,D,W,W,15,5,10,9,10
1001,2013-10-26,Hannover,Hoffenheim,1,4,A,12,20,13,22,13,10,L,L,D,D,L,D,-1,-2,1,3,10
1002,2013-10-26,Leverkusen,Augsburg,2,1,H,21,11,10,18,22,10,W,L,D,L,W,D,11,-7,18,12,10
1003,2013-10-26,Mainz,Braunschweig,2,0,H,13,6,20,21,10,4,L,L,D,W,L,L,-7,-15,8,6,10
1004,2013-10-26,Schalke 04,Dortmund,1,3,A,18,23,18,7,14,22,W,W,W,L,D,W,0,16,-16,-8,10
1005,2013-10-26,Wolfsburg,Werder Bremen,3,0,H,10,8,12,15,12,9,W,D,L,D,L,D,-2,-7,5,3,10
1006,2013-10-27,Freiburg,Hamburg,0,3,A,8,22,19,17,5,12,D,D,D,W,L,D,-11,5,-16,-7,10
1007,2013-10-27,M'gladbach,Ein Frankfurt,4,1,H,20,13,15,17,13,10,L,D,W,D,D,D,5,-4,9,3,10
1008,2013-11-01,Dortmund,Stuttgart,6,1,H,29,21,8,19,25,13,W,D,W,D,L,D,21,2,19,12,11
1009,2013-11-02,Braunschweig,Leverkusen,1,0,H,7,21,21,11,7,22,L,W,L,W,W,D,-14,10,-24,-15,11
1010,2013-11-02,Ein Frankfurt,Wolfsburg,1,2,A,14,12,19,13,10,15,L,W,D,W,D,L,-5,-1,-4,-5,11
1011,2013-11-02,Hamburg,M'gladbach,0,2,A,22,22,19,15,12,16,W,W,D,L,W,W,3,7,-4,-4,11
1012,2013-11-02,Hertha,Schalke 04,0,2,A,15,20,12,18,14,17,L,L,W,W,D,W,3,2,1,-3,11
1013,2013-11-02,Hoffenheim,Bayern Munich,1,2,A,21,23,24,7,10,26,W,W,L,W,D,D,-3,16,-19,-16,11
1014,2013-11-02,Nurnberg,Freiburg,0,3,A,9,11,20,19,6,8,D,L,D,D,L,D,-11,-8,-3,-2,11
1015,2013-11-03,Augsburg,Mainz,2,1,H,13,14,19,22,13,10,L,W,L,L,L,D,-6,-8,2,3,11
1016,2013-11-03,Werder Bremen,Hannover,3,2,H,11,14,17,16,12,13,L,L,D,L,D,D,-6,-2,-4,-1,11
1017,2013-11-08,Hannover,Braunschweig,0,0,D,14,7,16,21,14,8,L,W,L,L,L,L,-2,-14,12,6,12
1018,2013-11-09,Bayern Munich,Augsburg,3,0,H,26,13,7,22,29,13,W,W,W,L,W,L,19,-9,28,16,12
1019,2013-11-09,Hoffenheim,Hertha,2,3,A,23,18,27,14,10,17,L,L,W,L,L,W,-4,4,-8,-7,12
1020,2013-11-09,Leverkusen,Hamburg,5,3,H,26,25,14,24,25,12,L,L,W,W,W,D,12,1,11,13,12
1021,2013-11-09,M'gladbach,Nurnberg,3,1,H,25,10,16,23,19,6,W,L,W,D,L,D,9,-13,22,13,12
1022,2013-11-09,Schalke 04,Werder Bremen,3,1,H,23,12,19,20,20,12,W,W,L,L,W,D,4,-8,12,8,12
1023,2013-11-09,Wolfsburg,Dortmund,2,1,H,14,30,14,10,18,25,W,W,W,W,W,W,0,20,-20,-7,12
1024,2013-11-10,Freiburg,Stuttgart,1,3,A,12,24,22,20,8,16,W,L,L,D,D,D,-10,4,-14,-8,12
1025,2013-11-10,Mainz,Ein Frankfurt,1,0,H,15,14,22,20,13,10,L,L,W,L,L,D,-7,-6,-1,3,12
1026,2013-11-22,Stuttgart,M'gladbach,0,2,A,24,27,22,16,16,22,W,W,L,W,D,W,2,11,-9,-6,13
1027,2013-11-23,Augsburg,Hoffenheim,2,0,H,15,23,22,29,16,10,L,L,W,L,L,W,-7,-6,-1,6,13
1028,2013-11-23,Braunschweig,Freiburg,0,1,A,7,13,22,22,8,11,D,L,W,W,L,L,-15,-9,-6,-3,13
1029,2013-11-23,Dortmund,Bayern Munich,0,3,A,30,29,13,7,25,32,L,W,W,W,W,W,17,22,-5,-7,13
1030,2013-11-23,Ein Frankfurt,Schalke 04,3,3,D,17,26,23,22,11,21,L,W,L,W,L,L,-6,4,-10,-10,13
1031,2013-11-23,Hertha,Leverkusen,0,1,A,18,27,15,14,17,28,W,W,L,L,L,W,3,13,-10,-11,13
1032,2013-11-23,Nurnberg,Wolfsburg,1,1,D,11,15,24,15,7,19,L,W,L,W,D,W,-13,0,-13,-12,13
1033,2013-11-24,Hamburg,Hannover,3,1,H,28,15,25,19,15,14,L,D,L,L,W,L,3,-4,7,1,13
1034,2013-11-24,Werder Bremen,Mainz,2,3,A,14,18,23,24,12,16,L,W,W,L,L,W,-9,-6,-3,-4,13
1035,2013-11-29,Wolfsburg,Hamburg,1,1,D,16,29,16,26,20,16,D,W,W,L,W,L,0,3,-3,4,14
1036,2013-11-30,Bayern Munich,Braunschweig,2,0,H,31,7,7,24,35,8,W,L,W,D,W,W,24,-17,41,27,14
1037,2013-11-30,Hertha,Augsburg,0,0,D,18,15,15,22,18,17,L,W,W,L,L,W,3,-7,10,1,14
1038,2013-11-30,Hoffenheim,Werder Bremen,4,4,D,27,18,33,27,11,13,L,L,L,L,L,W,-6,-9,3,-2,14
1039,2013-11-30,Leverkusen,Nurnberg,3,0,H,30,11,14,27,31,7,W,D,W,L,L,L,16,-16,32,24,14
1040,2013-11-30,Mainz,Dortmund,1,3,A,19,33,27,14,16,28,W,L,W,L,L,W,-8,19,-27,-12,14
1041,2013-11-30,Schalke 04,Stuttgart,3,0,H,29,24,22,25,24,16,D,L,W,W,W,L,7,-1,8,8,14
1042,2013-12-01,Hannover,Ein Frankfurt,2,0,H,17,17,19,25,17,11,L,D,D,L,L,L,-2,-8,6,6,14
1043,2013-12-01,M'gladbach,Freiburg,1,0,H,28,13,16,23,25,11,W,W,W,L,W,W,12,-10,22,14,14
1044,2013-12-06,Nurnberg,Mainz,1,1,D,12,20,28,28,8,17,L,L,D,W,L,W,-16,-8,-8,-9,15
1045,2013-12-07,Dortmund,Leverkusen,0,1,A,33,31,15,14,28,34,W,W,L,W,L,W,18,17,1,-6,15
1046,2013-12-07,Ein Frankfurt,Hoffenheim,1,2,A,18,29,27,34,11,14,L,D,D,L,L,L,-9,-5,-4,-3,15
1047,2013-12-07,Hamburg,Augsburg,0,1,A,29,16,27,22,16,20,D,D,W,W,L,L,2,-6,8,-4,15
1048,2013-12-07,M'gladbach,Schalke 04,2,1,H,30,30,17,24,28,24,W,W,W,D,W,W,13,6,7,4,15
1049,2013-12-07,Stuttgart,Hannover,4,2,H,28,19,27,23,19,17,L,W,L,L,W,D,1,-4,5,2,15
1050,2013-12-07,Werder Bremen,Bayern Munich,0,7,A,18,38,34,7,13,38,D,W,L,W,L,W,-16,31,-47,-25,15
1051,2013-12-08,Braunschweig,Hertha,0,2,A,7,20,26,15,8,21,L,D,L,L,D,W,-19,5,-24,-13,15
1052,2013-12-08,Freiburg,Wolfsburg,0,3,A,13,19,26,16,11,23,L,D,W,D,L,W,-13,3,-16,-12,15
1053,2013-12-13,Hertha,Werder Bremen,3,2,H,23,20,17,37,24,13,W,L,D,D,L,L,6,-17,23,11,16
1054,2013-12-14,Augsburg,Braunschweig,4,1,H,20,8,23,30,23,8,W,L,D,L,W,L,-3,-22,19,15,16
1055,2013-12-14,Bayern Munich,Hamburg,3,1,H,41,30,8,30,41,16,W,L,W,D,W,W,33,0,33,25,16
1056,2013-12-14,Hannover,Nurnberg,3,3,D,22,15,26,31,18,9,L,D,W,L,L,D,-4,-16,12,9,16
1057,2013-12-14,Hoffenheim,Dortmund,2,2,D,31,35,36,17,15,29,W,L,D,W,L,L,-5,18,-23,-14,16
1058,2013-12-14,Mainz,M'gladbach,0,0,D,20,30,28,17,18,29,D,W,L,W,W,W,-8,13,-21,-11,16
1059,2013-12-14,Wolfsburg,Stuttgart,3,1,H,22,29,17,30,26,19,W,W,D,L,D,L,5,-1,6,7,16
1060,2013-12-15,Leverkusen,Ein Frankfurt,0,1,A,31,19,15,27,34,14,W,L,W,L,W,D,16,-8,24,20,16
1061,2013-12-15,Schalke 04,Freiburg,2,0,H,32,13,24,28,27,11,L,L,W,L,D,W,8,-15,23,16,16
1062,2013-12-20,Ein Frankfurt,Augsburg,1,1,D,20,21,28,24,15,24,W,W,L,W,L,D,-8,-3,-5,-9,17
1063,2013-12-21,Braunschweig,Hoffenheim,1,0,H,9,31,30,37,11,15,L,D,L,W,L,D,-21,-6,-15,-4,17
1064,2013-12-21,Dortmund,Hertha,1,2,A,36,25,19,18,29,27,D,W,L,W,W,D,17,7,10,2,17
1065,2013-12-21,Freiburg,Hannover,2,1,H,15,23,29,28,14,18,L,D,L,L,L,W,-14,-5,-9,-4,17
1066,2013-12-21,Hamburg,Mainz,2,3,A,32,23,33,30,16,21,L,D,L,D,D,L,-1,-7,6,-5,17
1067,2013-12-21,Nurnberg,Schalke 04,0,0,D,15,32,31,24,10,28,D,W,D,L,L,W,-16,8,-24,-18,17
1068,2013-12-21,Werder Bremen,Leverkusen,1,0,H,21,31,37,16,16,34,L,L,L,W,D,W,-16,15,-31,-18,17
1069,2013-12-22,M'gladbach,Wolfsburg,2,2,D,32,24,19,19,30,27,D,W,W,W,W,D,13,5,8,3,17
1070,2014-01-24,M'gladbach,Bayern Munich,0,2,A,32,43,19,8,30,44,D,W,W,W,W,W,13,35,-22,-14,17
1071,2014-01-25,Dortmund,Augsburg,2,2,D,38,23,21,26,30,25,L,D,D,W,L,W,17,-3,20,5,18
1072,2014-01-25,Ein Frankfurt,Hertha,1,0,H,21,25,28,19,18,27,D,W,W,W,L,W,-7,6,-13,-9,18
1073,2014-01-25,Freiburg,Leverkusen,3,2,H,18,33,31,19,17,34,W,L,L,L,L,W,-13,14,-27,-17,18
1074,2014-01-25,Nurnberg,Hoffenheim,4,0,H,19,31,31,41,13,15,D,L,D,D,D,W,-12,-10,-2,-2,18
1075,2014-01-25,Stuttgart,Mainz,1,2,A,31,25,34,31,19,24,L,W,L,D,W,D,-3,-6,3,-5,18
1076,2014-01-25,Wolfsburg,Hannover,1,3,A,25,26,22,29,27,21,D,L,W,D,W,L,3,-3,6,6,18
1077,2014-01-26,Hamburg,Schalke 04,0,3,A,32,35,36,24,16,31,L,D,L,W,L,L,-4,11,-15,-15,18
1078,2014-01-26,Werder Bremen,Braunschweig,0,0,D,21,9,37,30,17,12,W,W,L,L,L,L,-16,-21,5,5,18
1079,2014-01-29,Stuttgart,Bayern Munich,1,2,A,31,45,34,9,19,47,L,W,L,W,W,W,-3,36,-39,-28,18
1080,2014-01-31,Braunschweig,Dortmund,1,2,A,10,40,32,22,12,33,D,D,W,L,L,D,-22,18,-40,-21,19
1081,2014-02-01,Augsburg,Werder Bremen,3,1,H,26,22,27,40,28,17,D,D,D,W,W,L,-1,-18,17,11,19
1082,2014-02-01,Hannover,M'gladbach,3,1,H,29,33,30,24,24,30,W,L,L,D,D,D,-1,9,-10,-6,19
1083,2014-02-01,Hoffenheim,Hamburg,3,0,H,34,32,41,39,18,16,L,L,L,L,D,L,-7,-7,0,2,19
1084,2014-02-01,Leverkusen,Stuttgart,2,1,H,35,32,20,36,37,19,L,L,L,L,L,L,15,-4,19,18,19
1085,2014-02-01,Mainz,Freiburg,2,0,H,27,18,31,33,27,17,W,W,W,W,D,L,-4,-15,11,10,19
1086,2014-02-01,Schalke 04,Wolfsburg,2,1,H,37,26,25,24,34,27,W,L,D,D,W,W,12,2,10,7,19
1087,2014-02-02,Bayern Munich,Ein Frankfurt,5,0,H,50,21,9,33,50,18,W,W,W,D,W,W,41,-12,53,32,19
1088,2014-02-02,Hertha,Nurnberg,1,3,A,26,22,22,32,27,16,L,W,W,D,W,D,4,-10,14,11,19
1089,2014-02-07,M'gladbach,Leverkusen,0,1,A,33,36,25,20,30,40,L,W,L,L,D,L,8,16,-8,-10,20
1090,2014-02-08,Ein Frankfurt,Braunschweig,3,0,H,24,10,33,35,21,12,L,L,W,D,D,W,-9,-25,16,9,20
1091,2014-02-08,Freiburg,Hoffenheim,1,1,D,19,35,34,42,18,19,L,W,W,L,W,L,-15,-7,-8,-1,20
1092,2014-02-08,Hamburg,Hertha,0,3,A,32,29,42,22,16,30,L,L,L,L,L,W,-10,7,-17,-14,20
1093,2014-02-08,Nurnberg,Bayern Munich,0,2,A,22,52,34,9,16,53,W,W,W,W,D,W,-12,43,-55,-37,20
1094,2014-02-08,Werder Bremen,Dortmund,1,5,A,23,45,45,23,17,36,L,W,D,D,W,L,-22,22,-44,-19,20
1095,2014-02-08,Wolfsburg,Mainz,3,0,H,29,27,24,34,30,27,L,W,L,W,D,W,5,-7,12,3,20
1096,2014-02-09,Schalke 04,Hannover,2,0,H,39,29,25,32,37,24,W,W,W,W,D,L,14,-3,17,13,20
1097,2014-02-09,Stuttgart,Augsburg,1,4,A,33,30,40,28,19,31,L,W,L,D,L,D,-7,2,-9,-12,20
1098,2014-02-14,Mainz,Hannover,2,0,H,29,29,34,34,30,24,L,L,W,W,W,W,-5,-5,0,6,21
1099,2014-02-15,Bayern Munich,Freiburg,4,0,H,56,19,9,38,56,18,W,D,W,L,W,W,47,-19,66,38,21
1100,2014-02-15,Braunschweig,Hamburg,4,2,H,14,34,37,46,15,16,L,L,L,L,D,L,-23,-12,-11,-1,21
1101,2014-02-15,Dortmund,Ein Frankfurt,4,0,H,49,24,23,37,39,21,W,W,W,L,D,W,26,-13,39,18,21
1102,2014-02-15,Hoffenheim,Stuttgart,4,1,H,39,34,43,44,22,19,D,L,W,L,L,L,-4,-10,6,3,21
1103,2014-02-15,Leverkusen,Schalke 04,1,2,A,37,41,22,26,40,40,W,W,W,W,L,W,15,15,0,0,21
1104,2014-02-15,Werder Bremen,M'gladbach,1,1,D,24,34,46,26,18,31,L,L,L,L,D,L,-22,8,-30,-13,21
1105,2014-02-16,Augsburg,Nurnberg,0,1,A,30,23,29,34,31,19,W,L,W,W,D,W,1,-11,12,12,21
1106,2014-02-16,Hertha,Wolfsburg,1,2,A,30,31,24,25,30,33,W,W,L,L,L,L,6,6,0,-3,21
1107,2014-02-21,Schalke 04,Mainz,0,0,D,0,0,26,34,41,31,W,W,W,L,W,W,-26,-34,8,10,22
1108,2014-02-22,Freiburg,Augsburg,2,4,A,2,4,42,31,18,34,L,L,D,W,L,W,-40,-27,-13,-16,22
1109,2014-02-22,Hamburg,Dortmund,3,0,H,3,0,46,26,19,39,L,W,L,W,L,W,-43,-26,-17,-20,22
1110,2014-02-22,M'gladbach,Hoffenheim,2,2,D,2,2,28,45,32,23,D,W,L,D,L,W,-26,-43,17,9,22
1111,2014-02-22,Nurnberg,Braunschweig,2,1,H,2,1,35,39,22,15,W,W,L,L,W,L,-33,-38,5,7,22
1112,2014-02-22,Stuttgart,Hertha,1,2,A,1,2,46,25,19,33,L,L,L,W,L,L,-45,-23,-22,-14,22
1113,2014-02-22,Wolfsburg,Leverkusen,3,1,H,3,1,26,25,36,40,W,L,W,W,L,W,-23,-24,1,-4,22
1114,2014-02-23,Ein Frankfurt,Werder Bremen,0,0,D,0,0,37,46,22,19,L,D,W,L,L,L,-37,-46,9,3,22
1115,2014-02-23,Hannover,Bayern Munich,0,4,A,0,4,38,9,24,59,L,W,L,W,W,W,-38,-5,-33,-35,22
1116,2014-02-28,Hertha,Freiburg,0,0,D,0,0,25,42,34,19,W,L,L,L,W,D,-25,-42,17,15,23
1117,2014-03-01,Augsburg,Hannover,1,1,D,1,1,32,39,35,25,W,L,L,L,W,L,-31,-38,7,10,23
1118,2014-03-01,Bayern Munich,Schalke 04,5,1,H,5,1,10,31,62,41,W,D,W,W,W,W,-5,-30,25,21,23
1119,2014-03-01,Braunschweig,M'gladbach,1,1,D,1,1,40,29,16,33,L,D,W,D,L,L,-39,-28,-11,-17,23
1120,2014-03-01,Dortmund,Nurnberg,3,0,H,3,0,26,38,42,22,L,W,W,W,W,L,-23,-38,15,20,23
1121,2014-03-01,Leverkusen,Mainz,0,1,A,0,1,26,34,40,34,L,D,L,W,W,L,-26,-33,7,6,23
1122,2014-03-01,Werder Bremen,Hamburg,1,0,H,1,0,46,47,22,19,D,W,D,L,L,L,-45,-47,2,3,23
1123,2014-03-02,Ein Frankfurt,Stuttgart,2,1,H,2,1,38,48,25,19,D,L,L,L,W,L,-36,-47,11,6,23
1124,2014-03-02,Hoffenheim,Wolfsburg,6,2,H,6,2,47,32,26,36,D,W,W,W,D,W,-41,-30,-11,-10,23
1125,2014-03-08,Hamburg,Ein Frankfurt,1,1,D,1,1,48,39,20,26,L,W,W,D,L,L,-47,-38,-9,-6,24
1126,2014-03-08,Hannover,Leverkusen,1,1,D,1,1,40,27,26,41,D,L,L,L,L,L,-39,-26,-13,-15,24
1127,2014-03-08,M'gladbach,Augsburg,1,2,A,1,2,31,33,33,38,D,D,D,W,D,L,-30,-31,1,-5,24
1128,2014-03-08,Nurnberg,Werder Bremen,0,2,A,0,2,40,46,22,25,L,W,W,D,W,D,-40,-44,4,-3,24
1129,2014-03-08,Schalke 04,Hoffenheim,4,0,H,4,0,31,51,44,26,L,W,D,D,W,W,-27,-51,24,18,24
1130,2014-03-08,Stuttgart,Braunschweig,2,2,D,2,2,50,42,20,17,L,D,L,L,L,W,-48,-40,-8,3,24
1131,2014-03-08,Wolfsburg,Bayern Munich,1,6,A,1,6,38,11,36,65,L,W,W,W,W,W,-37,-5,-32,-29,24
1132,2014-03-09,Freiburg,Dortmund,0,1,A,0,1,43,26,19,45,D,W,L,L,L,W,-43,-25,-18,-26,24
1133,2014-03-09,Mainz,Hertha,1,1,D,1,1,35,26,35,35,W,D,D,W,W,L,-34,-25,-9,0,24
1134,2014-03-14,Augsburg,Schalke 04,1,2,A,1,2,35,32,38,47,W,W,D,L,W,D,-34,-30,-4,-9,25
1135,2014-03-15,Bayern Munich,Leverkusen,2,1,H,2,1,12,29,68,41,W,D,W,L,W,L,-10,-28,18,27,25
1136,2014-03-15,Braunschweig,Wolfsburg,1,1,D,1,1,43,39,18,37,D,L,D,L,L,W,-42,-38,-4,-19,25
1137,2014-03-15,Dortmund,M'gladbach,1,2,A,1,2,28,32,45,36,W,L,W,D,L,D,-27,-30,3,9,25
1138,2014-03-15,Hertha,Hannover,0,3,A,0,3,29,40,35,29,D,D,D,D,W,L,-29,-37,8,6,25
1139,2014-03-15,Hoffenheim,Mainz,2,4,A,2,4,55,37,26,38,L,D,W,W,D,D,-53,-33,-20,-12,25
1140,2014-03-15,Werder Bremen,Stuttgart,1,1,D,1,1,47,51,26,21,W,D,W,L,D,L,-46,-50,4,5,25
1141,2014-03-16,Ein Frankfurt,Freiburg,1,4,A,1,4,43,44,26,22,D,L,W,D,D,L,-42,-40,-2,4,25
1142,2014-03-16,Hamburg,Nurnberg,2,1,H,2,1,49,42,23,22,D,L,L,L,W,W,-47,-41,-6,1,25
1143,2014-03-21,Freiburg,Werder Bremen,3,1,H,3,1,45,50,25,26,W,D,L,W,D,W,-42,-49,7,-1,26
1144,2014-03-22,Hannover,Dortmund,0,3,A,0,3,43,28,29,48,W,L,D,W,D,W,-43,-25,-18,-19,26
1145,2014-03-22,Mainz,Bayern Munich,0,2,A,0,2,39,12,38,71,W,W,D,W,W,W,-39,-10,-29,-33,26
1146,2014-03-22,M'gladbach,Hertha,3,0,H,3,0,32,32,39,35,W,L,L,D,D,D,-29,-32,3,4,26
1147,2014-03-22,Schalke 04,Braunschweig,3,1,H,3,1,33,46,50,18,W,D,W,D,L,D,-30,-45,15,32,26
1148,2014-03-22,Stuttgart,Hamburg,1,0,H,1,0,51,50,24,23,D,W,D,D,L,L,-50,-50,0,1,26
1149,2014-03-22,Wolfsburg,Augsburg,1,1,D,1,1,40,36,38,39,D,L,L,W,L,D,-39,-35,-4,-1,26
1150,2014-03-23,Leverkusen,Hoffenheim,2,3,A,2,3,32,57,41,29,L,L,D,L,L,W,-30,-54,24,12,26
1151,2014-03-23,Nurnberg,Ein Frankfurt,2,5,A,2,5,47,45,22,29,L,L,L,D,L,W,-45,-40,-5,-7,26
1152,2014-03-25,Braunschweig,Mainz,3,1,H,3,1,47,42,21,38,L,L,D,W,D,D,-44,-41,-3,-17,27
1153,2014-03-25,Dortmund,Schalke 04,0,0,D,0,0,28,33,49,51,W,W,L,W,W,W,-28,-33,5,-2,27
1154,2014-03-25,Hertha,Bayern Munich,1,3,A,1,3,35,13,35,74,L,W,L,W,D,W,-34,-10,-24,-39,27
1155,2014-03-25,Werder Bremen,Wolfsburg,1,3,A,1,3,53,41,26,41,L,D,D,D,W,L,-52,-38,-14,-15,27
1156,2014-03-26,Augsburg,Leverkusen,1,3,A,1,3,39,33,39,44,D,L,L,L,W,D,-38,-30,-8,-5,27
1157,2014-03-26,Ein Frankfurt,M'gladbach,1,0,H,1,0,45,33,32,39,W,W,L,W,D,L,-44,-33,-11,-7,27
1158,2014-03-26,Hamburg,Freiburg,1,1,D,1,1,51,46,24,26,L,W,W,W,D,L,-50,-45,-5,-2,27
1159,2014-03-26,Hoffenheim,Hannover,3,1,H,3,1,58,46,32,29,W,L,L,W,L,D,-55,-45,-10,3,27
1160,2014-03-26,Nurnberg,Stuttgart,2,0,H,2,0,47,53,25,24,L,W,L,D,L,D,-45,-53,8,1,27
1161,2014-03-28,Schalke 04,Hertha,2,0,H,2,0,33,37,54,35,D,L,W,L,W,L,-31,-37,6,19,28
1162,2014-03-29,Bayern Munich,Hoffenheim,3,3,D,3,3,16,61,75,33,W,W,W,W,W,L,-13,-58,45,42,28
1163,2014-03-29,Freiburg,Nurnberg,3,2,H,3,2,48,50,29,25,D,W,W,L,W,L,-45,-48,3,4,28
1164,2014-03-29,Leverkusen,Braunschweig,1,1,D,1,1,34,48,45,22,W,W,L,L,L,D,-33,-47,14,23,28
1165,2014-03-29,Mainz,Augsburg,3,0,H,3,0,42,42,41,39,L,L,L,D,W,L,-39,-42,3,2,28
1166,2014-03-29,Stuttgart,Dortmund,2,3,A,2,3,56,30,24,52,L,D,W,W,D,L,-54,-27,-27,-28,28
1167,2014-03-29,Wolfsburg,Ein Frankfurt,2,1,H,2,1,42,47,44,32,W,W,D,W,D,L,-40,-46,6,12,28
1168,2014-03-30,Hannover,Werder Bremen,1,2,A,1,2,48,54,29,29,L,L,L,L,W,D,-47,-52,5,0,28
1169,2014-03-30,M'gladbach,Hamburg,3,1,H,3,1,34,54,42,24,L,D,W,L,W,W,-31,-53,22,18,28
1170,2014-04-04,Hamburg,Leverkusen,2,1,H,2,1,55,36,27,45,L,D,D,W,L,L,-53,-35,-18,-18,29
1171,2014-04-05,Augsburg,Bayern Munich,1,0,H,1,0,42,17,42,75,L,D,L,W,D,W,-41,-17,-24,-33,29
1172,2014-04-05,Dortmund,Wolfsburg,2,1,H,2,1,31,44,55,44,W,W,D,W,W,D,-29,-43,14,11,29
1173,2014-04-05,Ein Frankfurt,Mainz,2,0,H,2,0,47,44,35,41,L,W,W,L,W,L,-45,-44,-1,-6,29
1174,2014-04-05,Nurnberg,M'gladbach,0,2,A,0,2,52,34,25,45,L,W,W,L,L,W,-52,-32,-20,-20,29
1175,2014-04-05,Stuttgart,Freiburg,2,0,H,2,0,56,50,27,29,L,W,L,D,W,W,-54,-50,-4,-2,29
1176,2014-04-05,Werder Bremen,Schalke 04,1,1,D,1,1,55,34,30,55,W,W,L,D,L,W,-54,-33,-21,-25,29
1177,2014-04-06,Braunschweig,Hannover,3,0,H,3,0,48,51,25,29,D,L,W,L,L,L,-45,-51,6,-4,29
1178,2014-04-06,Hertha,Hoffenheim,1,1,D,1,1,38,62,36,34,L,D,L,W,L,W,-37,-61,24,2,29
1179,2014-04-11,Schalke 04,Ein Frankfurt,2,0,H,2,0,34,49,58,35,D,W,W,L,D,W,-32,-49,17,23,30
1180,2014-04-12,Bayern Munich,Dortmund,0,3,A,0,3,20,31,75,58,L,W,D,W,W,D,-20,-28,8,17,30
1181,2014-04-12,Freiburg,Braunschweig,2,0,H,2,0,50,50,32,25,L,W,W,D,D,W,-48,-50,2,7,30
1182,2014-04-12,Hannover,Hamburg,2,1,H,2,1,52,57,32,27,L,W,L,L,L,D,-50,-56,6,5,30
1183,2014-04-12,Mainz,Werder Bremen,3,0,H,3,0,44,58,44,30,L,D,W,W,L,L,-41,-58,17,14,30
1184,2014-04-12,M'gladbach,Stuttgart,1,1,D,1,1,35,57,46,28,W,W,W,L,L,L,-34,-56,22,18,30
1185,2014-04-12,Wolfsburg,Nurnberg,4,1,H,4,1,45,56,47,25,L,L,W,L,W,W,-41,-55,14,22,30
1186,2014-04-13,Hoffenheim,Augsburg,2,0,H,2,0,62,44,37,42,D,W,D,L,W,L,-60,-44,-16,-5,30
1187,2014-04-13,Leverkusen,Hertha,2,1,H,2,1,37,40,48,36,L,D,D,L,W,L,-35,-39,4,12,30
1188,2014-04-17,Ein Frankfurt,Hannover,2,3,A,2,3,52,54,35,35,L,W,W,L,L,L,-50,-51,1,0,31
1189,2014-04-19,Augsburg,Hertha,0,0,D,0,0,44,40,43,37,L,L,W,D,L,L,-44,-40,-4,6,31
1190,2014-04-19,Braunschweig,Bayern Munich,0,2,A,0,2,52,20,25,78,L,L,W,L,D,D,-52,-18,-34,-53,31
1191,2014-04-19,Dortmund,Mainz,4,2,H,4,2,33,48,61,44,W,W,W,L,W,W,-29,-46,17,17,31
1192,2014-04-19,Freiburg,M'gladbach,4,2,H,4,2,52,39,35,46,W,D,L,W,W,W,-48,-37,-11,-11,31
1193,2014-04-19,Hamburg,Wolfsburg,1,3,A,1,3,60,46,27,50,L,W,W,L,L,W,-59,-43,-16,-23,31
1194,2014-04-19,Werder Bremen,Hoffenheim,3,1,H,3,1,59,65,33,37,L,W,D,D,W,D,-56,-64,8,-4,31
1195,2014-04-20,Nurnberg,Leverkusen,1,4,A,1,4,60,38,25,51,L,W,L,L,L,D,-59,-34,-25,-26,31
1196,2014-04-20,Stuttgart,Schalke 04,3,1,H,3,1,58,37,31,58,D,W,W,D,L,W,-55,-36,-19,-27,31
1197,2014-04-25,Hannover,Stuttgart,0,0,D,0,0,54,58,36,32,W,W,W,D,L,W,-54,-58,4,4,32
1198,2014-04-26,Bayern Munich,Werder Bremen,5,2,H,5,2,22,64,81,33,W,W,L,L,L,D,-17,-62,45,48,32
1199,2014-04-26,Hertha,Braunschweig,2,0,H,2,0,40,54,40,25,D,L,L,L,D,W,-38,-54,16,15,32
1200,2014-04-26,Hoffenheim,Ein Frankfurt,0,0,D,0,0,65,52,38,36,L,L,W,L,D,W,-65,-52,-13,2,32
1201,2014-04-26,Leverkusen,Dortmund,2,2,D,2,2,40,35,52,62,W,W,W,W,L,W,-38,-33,-5,-10,32
1202,2014-04-26,Mainz,Nurnberg,2,0,H,2,0,48,62,47,25,L,L,W,L,L,L,-46,-62,16,22,32
1203,2014-04-26,Wolfsburg,Freiburg,2,2,D,2,2,48,54,51,36,W,W,W,W,L,L,-46,-52,6,15,32
1204,2014-04-27,Augsburg,Hamburg,3,1,H,3,1,45,63,46,27,D,L,L,L,W,W,-42,-62,20,19,32
1205,2014-04-27,Schalke 04,M'gladbach,0,1,A,0,1,38,39,58,49,L,L,W,D,D,W,-38,-38,0,9,32
1206,2014-05-03,Braunschweig,Augsburg,0,1,A,0,1,55,45,25,49,L,W,L,D,L,L,-55,-44,-11,-24,33
1207,2014-05-03,Dortmund,Hoffenheim,3,2,H,3,2,37,68,65,38,D,D,W,L,W,W,-34,-66,32,27,33
1208,2014-05-03,Ein Frankfurt,Leverkusen,0,2,A,0,2,54,40,36,55,D,D,L,W,L,W,-54,-38,-16,-19,33
1209,2014-05-03,Freiburg,Schalke 04,0,2,A,0,2,56,38,36,61,D,L,W,L,W,W,-56,-36,-20,-25,33
1210,2014-05-03,Hamburg,Bayern Munich,1,4,A,1,4,67,23,27,84,L,W,L,W,L,L,-66,-19,-47,-57,33
1211,2014-05-03,M'gladbach,Mainz,3,1,H,3,1,40,51,52,47,W,W,L,L,D,W,-37,-50,13,5,33
1212,2014-05-03,Nurnberg,Hannover,0,2,A,0,2,64,54,25,39,L,D,L,W,L,W,-64,-52,-12,-14,33
1213,2014-05-03,Stuttgart,Wolfsburg,1,2,A,1,2,60,49,32,54,D,D,W,W,D,W,-59,-47,-12,-22,33
1214,2014-05-03,Werder Bremen,Hertha,2,0,H,2,0,64,42,36,40,L,W,W,D,L,L,-62,-42,-20,-4,33
1215,2014-05-10,Augsburg,Ein Frankfurt,2,1,H,2,1,46,56,52,36,W,L,W,D,D,L,-44,-55,11,16,34
1216,2014-05-10,Bayern Munich,Stuttgart,1,0,H,1,0,23,61,87,32,W,L,W,D,W,W,-22,-61,39,55,34
1217,2014-05-10,Hannover,Freiburg,3,2,H,3,2,56,59,42,36,W,L,D,D,W,W,-53,-57,4,6,34
1218,2014-05-10,Hertha,Dortmund,0,4,A,0,4,46,37,40,68,L,W,W,D,D,W,-46,-33,-13,-28,34
1219,2014-05-10,Hoffenheim,Braunschweig,3,1,H,3,1,69,58,41,25,L,L,D,L,L,L,-66,-57,-9,16,34
1220,2014-05-10,Leverkusen,Werder Bremen,2,1,H,2,1,41,66,58,36,W,W,D,L,W,W,-39,-65,26,22,34
1221,2014-05-10,Mainz,Hamburg,3,2,H,3,2,53,70,50,27,L,L,W,L,L,L,-50,-68,18,23,34
1222,2014-05-10,Schalke 04,Nurnberg,4,1,H,4,1,39,68,64,25,W,L,L,L,L,L,-35,-67,32,39,34
1223,2014-05-10,Wolfsburg,M'gladbach,3,1,H,3,1,50,43,57,52,W,W,D,W,W,L,-47,-42,-5,5,34
1224,2011-08-05,Dortmund,Hamburg,3,1,H,0,0,0,0,0,0,M,M,M,M,M,M,0,0,0,0,1
1225,2011-08-06,Augsburg,Freiburg,2,2,D,0,0,0,0,0,0,M,M,M,M,M,M,0,0,0,0,1
1226,2011-08-06,FC Koln,Wolfsburg,0,3,A,0,0,0,0,0,0,M,M,M,M,M,M,0,0,0,0,1
1227,2011-08-06,Hannover,Hoffenheim,2,1,H,0,0,0,0,0,0,M,M,M,M,M,M,0,0,0,0,1
1228,2011-08-06,Hertha,Nurnberg,0,1,A,0,0,0,0,0,0,M,M,M,M,M,M,0,0,0,0,1
1229,2011-08-06,Stuttgart,Schalke 04,3,0,H,0,0,0,0,0,0,M,M,M,M,M,M,0,0,0,0,1
1230,2011-08-06,Werder Bremen,Kaiserslautern,2,0,H,0,0,0,0,0,0,M,M,M,M,M,M,0,0,0,0,1
1231,2011-08-07,Bayern Munich,M'gladbach,0,1,A,0,0,0,0,0,0,M,M,M,M,M,M,0,0,0,0,1
1232,2011-08-07,Mainz,Leverkusen,2,0,H,0,0,0,0,0,0,M,M,M,M,M,M,0,0,0,0,1
1233,2011-08-13,Freiburg,Mainz,1,2,A,2,2,2,0,1,3,M,M,M,M,M,M,0,2,-2,-2,2
1234,2011-08-13,Hamburg,Hertha,2,2,D,1,0,3,1,0,0,M,M,M,M,M,M,-2,-1,-1,0,2
1235,2011-08-13,Hoffenheim,Dortmund,1,0,H,1,3,2,1,0,3,M,M,M,M,M,M,-1,2,-3,-3,2
1236,2011-08-13,M'gladbach,Stuttgart,1,1,D,1,3,0,0,3,3,M,M,M,M,M,M,1,3,-2,0,2
1237,2011-08-13,Nurnberg,Hannover,1,2,A,1,2,0,1,3,3,M,M,M,M,M,M,1,1,0,0,2
1238,2011-08-13,Schalke 04,FC Koln,5,1,H,0,0,3,3,0,0,M,M,M,M,M,M,-3,-3,0,0,2
1239,2011-08-13,Wolfsburg,Bayern Munich,0,1,A,3,0,0,1,3,0,M,M,M,M,M,M,3,-1,4,3,2
1240,2011-08-14,Kaiserslautern,Augsburg,1,1,D,0,2,2,2,0,1,M,M,M,M,M,M,-2,0,-2,-1,2
1241,2011-08-14,Leverkusen,Werder Bremen,1,0,H,0,2,2,0,0,3,M,M,M,M,M,M,-2,2,-4,-3,2
1242,2011-08-19,M'gladbach,Wolfsburg,4,1,H,5,4,1,4,6,3,D,L,M,M,M,M,4,0,4,3,3
1243,2011-08-20,Augsburg,Hoffenheim,0,2,A,2,3,4,2,1,3,D,W,M,M,M,M,-2,1,-3,-2,3
1244,2011-08-20,Bayern Munich,Hamburg,5,0,H,5,1,1,8,3,0,W,D,M,M,M,M,4,-7,11,3,3
1245,2011-08-20,Dortmund,Nurnberg,2,0,H,5,1,1,2,6,3,L,L,M,M,M,M,4,-1,5,3,3
1246,2011-08-20,FC Koln,Kaiserslautern,1,1,D,1,1,4,3,1,1,L,D,M,M,M,M,-3,-2,-1,0,3
1247,2011-08-20,Stuttgart,Leverkusen,0,1,A,3,1,1,2,3,3,D,W,M,M,M,M,2,-1,3,0,3
1248,2011-08-20,Werder Bremen,Freiburg,5,3,H,7,5,3,7,6,1,L,L,M,M,M,M,4,-2,6,5,3
1249,2011-08-21,Hannover,Hertha,1,1,D,3,1,2,2,4,1,W,D,M,M,M,M,1,-1,2,3,3
1250,2011-08-21,Mainz,Schalke 04,2,4,A,4,4,4,5,3,3,W,W,M,M,M,M,0,-1,1,0,3
1251,2011-08-26,Hertha,Stuttgart,1,0,H,2,3,2,2,4,3,D,L,D,D,M,M,0,1,-1,1,4
1252,2011-08-27,Freiburg,Wolfsburg,3,0,H,8,4,7,7,4,3,L,L,L,L,M,M,1,-3,4,1,4
1253,2011-08-27,Hamburg,FC Koln,3,4,A,4,5,12,7,0,4,L,D,D,L,M,M,-8,-2,-6,-4,4
1254,2011-08-27,Hoffenheim,Werder Bremen,1,2,A,4,9,4,4,3,9,W,W,W,L,M,M,0,5,-5,-6,4
1255,2011-08-27,Kaiserslautern,Bayern Munich,0,3,A,1,8,6,1,1,6,D,W,D,W,M,M,-5,7,-12,-5,4
1256,2011-08-27,Leverkusen,Dortmund,0,0,D,1,5,2,1,4,7,W,W,W,L,M,M,-1,4,-5,-3,4
1257,2011-08-27,Nurnberg,Augsburg,1,0,H,2,2,2,5,6,1,L,L,L,D,M,M,0,-3,3,5,4
1258,2011-08-28,Hannover,Mainz,1,1,D,4,5,3,5,5,4,D,L,W,W,M,M,1,0,1,1,4
1259,2011-08-28,Schalke 04,M'gladbach,1,0,H,5,5,5,2,6,6,W,W,W,D,M,M,0,3,-3,0,4
1260,2011-09-09,Augsburg,Leverkusen,1,4,A,3,5,9,3,1,7,L,D,L,W,D,W,-6,2,-8,-6,5
1261,2011-09-10,Bayern Munich,Freiburg,7,0,H,15,8,1,14,9,4,W,W,W,L,W,L,14,-6,20,5,5
1262,2011-09-10,Dortmund,Hertha,1,2,A,6,4,3,3,7,7,D,W,W,D,L,D,3,1,2,0,5
1263,2011-09-10,Mainz,Hoffenheim,0,4,A,5,8,9,4,4,6,D,L,L,W,W,W,-4,4,-8,-2,5
1264,2011-09-10,M'gladbach,Kaiserslautern,1,0,H,6,1,2,7,9,1,L,L,W,D,D,D,4,-6,10,8,5
1265,2011-09-10,Stuttgart,Hannover,3,0,H,6,4,2,6,6,5,L,D,L,D,D,W,4,-2,6,1,5
1266,2011-09-10,Werder Bremen,Hamburg,2,0,H,11,4,4,14,12,0,W,L,W,L,L,D,7,-10,17,12,5
1267,2011-09-11,FC Koln,Nurnberg,1,2,A,6,4,9,3,4,9,W,W,D,L,L,L,-3,1,-4,-5,5
1268,2011-09-11,Wolfsburg,Schalke 04,2,1,H,6,6,8,7,6,6,L,W,L,W,L,W,-2,-1,-1,0,5
1269,2011-09-16,Freiburg,Stuttgart,1,2,A,9,8,16,3,4,9,L,W,W,L,L,L,-7,5,-12,-5,6
1270,2011-09-17,Hamburg,M'gladbach,0,1,A,4,7,15,2,0,12,L,W,L,L,L,W,-11,5,-16,-12,6
1271,2011-09-17,Hertha,Augsburg,2,2,D,6,5,5,11,8,2,W,L,W,L,D,L,1,-6,7,6,6
1272,2011-09-17,Hoffenheim,Wolfsburg,3,1,H,11,7,5,11,9,6,W,W,L,L,W,L,6,-4,10,3,6
1273,2011-09-17,Kaiserslautern,Mainz,3,1,H,4,6,8,12,4,4,L,L,L,D,D,L,-4,-6,2,0,6
1274,2011-09-17,Leverkusen,FC Koln,1,4,A,6,10,7,10,7,7,W,L,D,W,W,D,-1,0,-1,0,6
1275,2011-09-17,Nurnberg,Werder Bremen,1,1,D,5,12,4,5,10,13,W,W,W,W,L,W,1,7,-6,-3,6
1276,2011-09-18,Hannover,Dortmund,2,1,H,6,7,7,5,8,7,L,L,D,D,D,W,-1,2,-3,1,6
1277,2011-09-18,Schalke 04,Bayern Munich,0,2,A,6,17,9,1,6,12,L,W,W,W,W,W,-3,16,-19,-6,6
1278,2011-09-23,Stuttgart,Hamburg,1,2,A,9,6,5,16,9,3,W,L,W,L,L,L,4,-10,14,6,7
1279,2011-09-24,Augsburg,Hannover,0,0,D,5,6,11,7,3,9,D,W,L,L,L,D,-6,-1,-5,-6,7
1280,2011-09-24,Bayern Munich,Leverkusen,3,0,H,20,6,1,10,15,7,W,L,W,W,W,D,19,-4,23,8,7
1281,2011-09-24,Mainz,Dortmund,1,2,A,7,9,14,6,4,10,L,L,L,L,D,D,-7,3,-10,-6,7
1282,2011-09-24,M'gladbach,Nurnberg,1,0,H,8,5,2,5,15,10,W,D,W,W,L,W,6,0,6,5,7
1283,2011-09-24,Schalke 04,Freiburg,4,2,H,10,11,11,20,9,4,L,L,L,L,W,W,-1,-9,8,5,7
1284,2011-09-24,Wolfsburg,Kaiserslautern,1,0,H,8,4,11,9,9,4,L,W,W,L,L,L,-3,-5,2,5,7
1285,2011-09-25,FC Koln,Hoffenheim,2,0,H,12,11,10,7,10,9,W,W,L,W,W,L,2,4,-2,1,7
1286,2011-09-25,Werder Bremen,Hertha,2,1,H,14,7,6,7,16,8,D,D,W,W,W,W,8,0,8,8,7
1287,2011-09-30,Kaiserslautern,Stuttgart,0,2,A,4,11,11,5,4,12,L,L,W,W,L,W,-7,6,-13,-8,8
1288,2011-10-01,Dortmund,Augsburg,4,0,H,13,5,6,15,13,3,W,D,L,D,L,L,7,-10,17,10,8
1289,2011-10-01,Freiburg,M'gladbach,1,0,H,12,8,20,3,7,15,L,W,L,W,L,W,-8,5,-13,-8,8
1290,2011-10-01,Hertha,FC Koln,3,0,H,10,12,7,13,11,10,L,W,D,W,W,L,3,-1,4,1,8
1291,2011-10-01,Hoffenheim,Bayern Munich,0,0,D,11,20,7,1,10,16,L,W,W,W,W,W,4,19,-15,-6,8
1292,2011-10-01,Leverkusen,Wolfsburg,3,1,H,9,9,11,14,10,9,L,W,L,L,W,W,-2,-5,3,1,8
1293,2011-10-01,Nurnberg,Mainz,3,3,D,8,10,8,17,11,5,L,L,D,L,W,L,0,-7,7,6,8
1294,2011-10-02,Hamburg,Schalke 04,1,2,A,7,12,18,12,3,12,W,W,L,L,L,L,-11,0,-11,-9,8
1295,2011-10-02,Hannover,Werder Bremen,3,2,H,9,16,9,9,12,16,D,W,W,D,L,W,0,7,-7,-4,8
1296,2011-10-14,Werder Bremen,Dortmund,0,2,A,16,15,11,6,16,16,L,W,W,W,D,L,5,9,-4,0,9
1297,2011-10-15,Bayern Munich,Hertha,4,0,H,24,10,1,11,19,11,D,W,W,L,W,D,23,-1,24,8,9
1298,2011-10-15,Mainz,Augsburg,0,1,A,10,6,18,15,5,6,D,L,L,D,L,D,-8,-9,1,-1,9
1299,2011-10-15,M'gladbach,Leverkusen,2,2,D,10,11,5,13,16,11,L,W,W,L,W,L,5,-2,7,5,9
1300,2011-10-15,Schalke 04,Kaiserslautern,1,2,A,13,6,14,12,12,7,W,L,W,L,L,W,-1,-6,5,5,9
1301,2011-10-15,Stuttgart,Hoffenheim,2,0,H,13,11,5,9,15,10,W,D,L,L,W,W,8,2,6,5,9
1302,2011-10-15,Wolfsburg,Nurnberg,2,1,H,11,9,15,10,12,11,L,D,W,L,L,D,-4,-1,-3,1,9
1303,2011-10-16,FC Koln,Hannover,2,0,H,14,9,13,11,13,12,L,W,W,D,W,W,1,-2,3,1,9
1304,2011-10-16,Freiburg,Hamburg,1,2,A,13,9,22,19,7,6,W,L,L,W,L,L,-9,-10,1,1,9
1305,2011-10-21,Augsburg,Werder Bremen,1,1,D,7,17,16,12,7,17,W,L,L,L,D,W,-9,5,-14,-10,10
1306,2011-10-22,Dortmund,FC Koln,5,0,H,20,14,6,18,19,13,W,W,W,L,W,W,14,-4,18,6,10
1307,2011-10-22,Hamburg,Wolfsburg,1,1,D,10,12,20,16,7,13,W,W,L,L,W,W,-10,-4,-6,-6,10
1308,2011-10-22,Hertha,Mainz,0,0,D,10,10,11,18,12,6,L,L,W,D,L,L,-1,-8,7,6,10
1309,2011-10-22,Hoffenheim,M'gladbach,1,0,H,12,10,9,6,13,16,L,D,D,L,L,W,3,4,-1,-3,10
1310,2011-10-22,Kaiserslautern,Freiburg,1,0,H,7,13,12,23,10,7,W,L,L,W,L,L,-5,-10,5,3,10
1311,2011-10-22,Nurnberg,Stuttgart,2,2,D,11,15,12,7,12,16,L,W,D,W,L,L,-1,8,-9,-4,10
1312,2011-10-23,Hannover,Bayern Munich,2,1,H,11,25,12,3,15,19,L,W,W,D,D,W,-1,22,-23,-4,10
1313,2011-10-23,Leverkusen,Schalke 04,0,1,A,11,14,14,14,11,15,D,L,W,W,L,W,-3,0,-3,-4,10
1314,2011-10-28,Freiburg,Leverkusen,0,1,A,13,12,24,14,7,14,L,L,L,D,W,W,-11,-2,-9,-7,11
1315,2011-10-29,Bayern Munich,Nurnberg,4,0,H,29,11,3,16,22,12,L,D,W,L,D,D,26,-5,31,10,11
1316,2011-10-29,Mainz,Werder Bremen,1,3,A,11,20,21,13,6,20,D,D,L,L,D,L,-10,7,-17,-14,11
1317,2011-10-29,M'gladbach,Hannover,2,1,H,12,12,7,14,19,15,L,W,D,L,L,W,5,-2,7,4,11
1318,2011-10-29,Schalke 04,Hoffenheim,3,1,H,17,13,15,12,18,13,W,W,L,L,W,D,2,1,1,5,11
1319,2011-10-29,Stuttgart,Dortmund,1,1,D,16,21,8,7,17,20,D,W,W,W,W,W,8,14,-6,-3,11
1320,2011-10-29,Wolfsburg,Hertha,2,3,A,14,13,19,13,13,15,D,D,W,L,L,W,-5,0,-5,-2,11
1321,2011-10-30,FC Koln,Augsburg,3,0,H,17,7,18,19,16,7,L,D,W,W,L,L,-1,-12,11,9,11
1322,2011-10-30,Hamburg,Kaiserslautern,1,1,D,11,8,21,13,8,11,D,W,W,W,L,L,-10,-5,-5,-3,11
1323,2011-11-04,Mainz,Stuttgart,3,1,H,14,17,22,11,9,17,L,D,D,D,L,W,-8,6,-14,-8,12
1324,2011-11-05,Dortmund,Wolfsburg,5,1,H,26,15,8,24,23,13,D,L,W,D,W,W,18,-9,27,10,12
1325,2011-11-05,Hertha,M'gladbach,1,2,A,14,14,15,8,15,22,W,W,D,L,L,D,-1,6,-7,-7,12
1326,2011-11-05,Hoffenheim,Kaiserslautern,1,1,D,14,9,13,14,14,12,L,D,W,W,L,W,1,-5,6,2,12
1327,2011-11-05,Leverkusen,Hamburg,2,2,D,14,13,16,23,15,9,W,D,L,D,D,W,-2,-10,8,6,12
1328,2011-11-05,Nurnberg,Freiburg,1,2,A,12,15,18,25,12,10,L,L,D,L,L,L,-6,-10,4,2,12
1329,2011-11-05,Werder Bremen,FC Koln,3,2,H,23,19,15,21,23,16,W,W,D,L,L,W,8,-2,10,7,12
1330,2011-11-06,Augsburg,Bayern Munich,1,2,A,8,31,21,4,7,25,L,W,D,L,W,W,-13,27,-40,-18,12
1331,2011-11-06,Hannover,Schalke 04,2,2,D,14,19,16,17,16,19,L,W,W,W,L,L,-2,2,-4,-3,12
1332,2011-11-18,Kaiserslautern,Leverkusen,0,2,A,9,16,16,16,12,18,D,D,D,W,W,L,-7,0,-7,-6,13
1333,2011-11-19,Bayern Munich,Dortmund,0,1,A,31,27,5,8,25,26,W,W,W,D,L,W,26,19,7,-1,13
1334,2011-11-19,Freiburg,Hertha,2,2,D,17,16,27,17,11,16,W,L,L,W,L,D,-10,-1,-9,-5,13
1335,2011-11-19,M'gladbach,Werder Bremen,5,0,H,19,23,8,20,25,23,W,W,W,W,L,D,11,3,8,2,13
1336,2011-11-19,Schalke 04,Nurnberg,4,0,H,23,12,17,22,22,12,D,L,W,L,W,D,6,-10,16,10,13
1337,2011-11-19,Wolfsburg,Hannover,4,1,H,19,15,25,20,16,16,L,D,L,L,D,W,-6,-5,-1,0,13
1338,2011-11-20,Hamburg,Hoffenheim,2,0,H,15,14,23,15,12,14,D,D,D,L,D,W,-8,-1,-7,-2,13
1339,2011-11-20,Stuttgart,Augsburg,2,1,H,19,9,12,23,20,7,L,L,D,L,D,D,7,-14,21,13,13
1340,2011-11-25,FC Koln,M'gladbach,0,3,A,19,19,24,8,16,25,L,W,W,W,L,L,-5,11,-16,-9,13
1341,2011-11-26,Augsburg,Wolfsburg,2,0,H,11,19,23,27,10,16,L,W,L,L,L,L,-12,-8,-4,-6,14
1342,2011-11-26,Dortmund,Schalke 04,2,0,H,29,23,8,19,29,22,W,W,W,D,D,W,21,4,17,7,14
1343,2011-11-26,Hannover,Hamburg,1,1,D,16,16,21,24,17,13,L,W,D,D,L,D,-5,-8,3,4,14
1344,2011-11-26,Hertha,Leverkusen,3,3,D,19,19,20,19,17,19,D,W,L,D,W,W,-1,0,-1,-2,14
1345,2011-11-26,Hoffenheim,Freiburg,1,1,D,15,18,16,28,15,12,L,D,D,W,L,L,-1,-10,9,3,14
1346,2011-11-26,Nurnberg,Kaiserslautern,1,0,H,13,9,22,17,15,12,L,L,L,D,L,D,-9,-8,-1,3,14
1347,2011-11-27,Mainz,Bayern Munich,3,2,H,19,33,26,8,13,25,W,L,W,W,L,W,-7,25,-32,-12,14
1348,2011-11-27,Werder Bremen,Stuttgart,2,0,H,25,19,20,14,26,20,L,W,W,L,W,D,5,5,0,6,14
1349,2011-12-02,Leverkusen,Hoffenheim,2,0,H,19,15,19,16,19,15,W,L,D,D,W,L,0,-1,1,4,14
1350,2011-12-03,Bayern Munich,Werder Bremen,4,1,H,37,26,9,24,28,26,L,W,L,L,W,W,28,2,26,2,15
1351,2011-12-03,Freiburg,Hannover,1,1,D,19,17,29,22,13,18,D,D,D,L,W,D,-10,-5,-5,-5,15
1352,2011-12-03,Kaiserslautern,Hertha,1,1,D,10,20,18,21,13,18,L,D,L,D,D,L,-8,-1,-7,-5,15
1353,2011-12-03,M'gladbach,Dortmund,1,1,D,23,30,9,9,29,30,W,W,W,W,W,W,14,21,-7,-1,15
1354,2011-12-03,Stuttgart,FC Koln,2,2,D,21,25,16,26,21,20,L,D,W,L,L,L,5,-1,6,1,15
1355,2011-12-03,Wolfsburg,Mainz,2,2,D,21,19,29,26,17,14,L,D,W,W,L,W,-8,-7,-1,3,15
1356,2011-12-04,Hamburg,Nurnberg,2,0,H,18,13,24,24,16,15,D,W,W,L,D,L,-6,-11,5,1,15
1357,2011-12-04,Schalke 04,Augsburg,3,1,H,26,12,20,26,25,10,L,W,W,L,D,L,6,-14,20,15,15
1358,2011-12-09,Hertha,Schalke 04,1,2,A,20,26,21,20,18,25,D,L,D,W,L,D,-1,6,-7,-7,15
1359,2011-12-10,Augsburg,M'gladbach,1,0,H,13,23,26,10,13,29,L,D,W,W,L,W,-13,13,-26,-16,16
1360,2011-12-10,FC Koln,Freiburg,4,0,H,26,19,27,33,21,13,W,D,D,D,L,D,-1,-14,13,8,16
1361,2011-12-10,Hannover,Leverkusen,0,0,D,17,21,22,19,19,23,D,W,D,D,L,W,-5,2,-7,-4,16
1362,2011-12-10,Mainz,Hamburg,0,0,D,20,18,27,24,15,17,D,W,D,D,W,W,-7,-6,-1,-2,16
1363,2011-12-10,Nurnberg,Hoffenheim,0,2,A,13,17,26,18,15,18,L,L,W,D,L,L,-13,-1,-12,-3,16
1364,2011-12-10,Werder Bremen,Wolfsburg,4,1,H,30,22,25,33,29,17,L,D,W,L,L,W,5,-11,16,12,16
1365,2011-12-11,Dortmund,Kaiserslautern,1,1,D,31,11,10,19,31,14,D,D,W,L,W,L,21,-8,29,17,16
1366,2011-12-11,Stuttgart,Bayern Munich,1,2,A,22,39,18,10,21,31,D,W,L,L,W,L,4,29,-25,-10,16
1367,2011-12-13,FC Koln,Mainz,1,1,D,26,20,27,27,21,15,W,D,D,D,L,W,-1,-7,6,6,16
1368,2011-12-16,Bayern Munich,FC Koln,3,0,H,42,26,10,30,34,21,W,D,W,W,L,D,32,-4,36,13,17
1369,2011-12-17,Freiburg,Dortmund,1,4,A,20,35,37,11,13,34,L,D,D,D,D,W,-17,24,-41,-21,17
1370,2011-12-17,Hamburg,Augsburg,1,1,D,19,14,25,27,18,14,D,W,W,L,D,W,-6,-13,7,4,17
1371,2011-12-17,Hoffenheim,Hertha,1,1,D,18,22,19,24,19,19,W,L,L,D,D,D,-1,-2,1,0,17
1372,2011-12-17,Leverkusen,Nurnberg,0,3,A,21,16,22,26,23,18,D,L,W,L,D,W,-1,-10,9,5,17
1373,2011-12-17,Schalke 04,Werder Bremen,5,0,H,33,30,21,30,31,29,W,W,W,L,L,W,12,0,12,2,17
1374,2011-12-17,Wolfsburg,Stuttgart,1,0,H,23,22,33,19,20,21,L,L,D,D,L,L,-10,3,-13,-1,17
1375,2011-12-18,Kaiserslautern,Hannover,1,1,D,12,18,20,23,15,20,D,D,D,D,L,D,-8,-5,-3,-5,17
1376,2011-12-18,M'gladbach,Mainz,1,0,H,24,20,10,28,32,15,L,D,D,D,W,D,14,-8,22,17,17
1377,2012-01-20,M'gladbach,Bayern Munich,3,1,H,27,43,11,13,35,34,W,W,L,W,D,W,16,30,-14,1,18
1378,2012-01-21,Freiburg,Augsburg,1,0,H,21,14,37,28,16,14,L,D,L,W,D,L,-16,-14,-2,2,18
1379,2012-01-21,Hoffenheim,Hannover,0,0,D,18,18,19,23,20,21,D,D,W,D,L,D,-1,-5,4,-1,18
1380,2012-01-21,Kaiserslautern,Werder Bremen,0,0,D,12,30,20,30,16,30,D,L,D,W,D,L,-8,0,-8,-14,18
1381,2012-01-21,Nurnberg,Hertha,2,0,H,18,22,26,26,21,19,W,D,L,L,L,D,-8,-4,-4,2,18
1382,2012-01-21,Schalke 04,Stuttgart,3,1,H,36,23,22,22,34,21,W,L,W,L,W,D,14,1,13,13,18
1383,2012-01-21,Wolfsburg,FC Koln,1,0,H,24,26,33,31,23,21,W,L,L,D,D,W,-9,-5,-4,2,18
1384,2012-01-22,Hamburg,Dortmund,1,5,A,20,40,30,12,18,37,D,W,D,D,W,D,-10,28,-38,-19,18
1385,2012-01-22,Leverkusen,Mainz,3,2,H,24,22,24,31,26,15,L,L,D,D,W,D,0,-9,9,11,18
1386,2012-01-27,Hannover,Nurnberg,1,0,H,19,18,23,27,24,21,D,W,D,W,D,L,-4,-9,5,3,19
1387,2012-01-28,Augsburg,Kaiserslautern,2,2,D,16,14,30,22,15,17,L,D,D,D,W,D,-14,-8,-6,-2,19
1388,2012-01-28,Bayern Munich,Wolfsburg,2,0,H,45,24,13,35,37,23,L,W,W,W,W,L,32,-11,43,14,19
1389,2012-01-28,Dortmund,Hoffenheim,3,1,H,43,19,13,22,40,20,W,D,W,D,D,W,30,-3,33,20,19
1390,2012-01-28,FC Koln,Schalke 04,1,4,A,27,40,35,23,21,37,L,W,L,W,D,W,-8,17,-25,-16,19
1391,2012-01-28,Hertha,Hamburg,1,2,A,23,22,28,31,19,21,L,L,D,D,L,D,-5,-9,4,-2,19
1392,2012-01-28,Werder Bremen,Leverkusen,1,1,D,31,25,31,25,31,27,D,W,L,L,W,D,0,0,0,4,19
1393,2012-01-29,Mainz,Freiburg,3,1,H,25,22,32,40,18,16,L,W,L,L,D,L,-7,-18,11,2,19
1394,2012-01-29,Stuttgart,M'gladbach,0,3,A,23,30,25,11,21,38,L,W,L,W,L,L,-2,19,-21,-17,19
1395,2012-02-03,Nurnberg,Dortmund,0,2,A,18,45,29,13,21,43,L,W,W,W,W,W,-11,32,-43,-22,20
1396,2012-02-04,Hamburg,Bayern Munich,1,1,D,23,46,32,14,22,38,W,W,L,L,D,W,-9,32,-41,-16,20
1397,2012-02-04,Hertha,Hannover,0,1,A,23,20,29,23,19,27,L,W,L,D,D,D,-6,-3,-3,-8,20
1398,2012-02-04,Hoffenheim,Augsburg,2,2,D,21,18,24,32,21,16,L,D,D,L,D,D,-3,-14,11,5,20
1399,2012-02-04,Leverkusen,Stuttgart,2,2,D,27,25,27,27,28,22,D,L,W,L,L,L,0,-2,2,6,20
1400,2012-02-04,Schalke 04,Mainz,1,1,D,41,26,24,33,38,19,W,W,W,L,W,L,17,-7,24,19,20
1401,2012-02-04,Wolfsburg,M'gladbach,0,0,D,24,30,35,11,24,39,L,W,W,W,W,W,-11,19,-30,-15,20
1402,2012-02-05,Freiburg,Werder Bremen,2,2,D,24,33,42,33,17,32,L,D,W,D,L,L,-18,0,-18,-15,20
1403,2012-02-05,Kaiserslautern,FC Koln,0,1,A,14,28,23,35,17,24,D,L,D,L,D,L,-9,-7,-2,-7,20
1404,2012-02-10,Wolfsburg,Freiburg,3,2,H,27,26,37,45,27,17,D,D,L,L,W,W,-10,-19,9,10,21
1405,2012-02-11,Bayern Munich,Kaiserslautern,2,0,H,48,14,14,25,41,17,D,L,W,D,L,D,34,-11,45,24,21
1406,2012-02-11,Dortmund,Leverkusen,1,0,H,46,27,13,28,46,28,W,D,W,D,W,W,33,-1,34,18,21
1407,2012-02-11,Mainz,Hannover,1,1,D,27,21,34,24,20,28,D,W,W,W,L,D,-7,-3,-4,-8,21
1408,2012-02-11,M'gladbach,Schalke 04,3,0,H,33,41,11,27,42,38,D,D,W,W,W,W,22,14,8,4,21
1409,2012-02-11,Stuttgart,Hertha,5,0,H,30,23,27,34,25,19,D,L,L,L,L,L,3,-11,14,6,21
1410,2012-02-11,Werder Bremen,Hoffenheim,1,1,D,34,22,34,25,33,22,D,D,D,L,D,D,0,-3,3,11,21
1411,2012-02-12,Augsburg,Nurnberg,0,0,D,18,18,32,29,17,22,D,L,D,L,L,W,-14,-11,-3,-5,21
1412,2012-02-12,FC Koln,Hamburg,0,1,A,28,24,36,32,24,25,W,D,L,W,L,L,-8,-8,0,-1,21
1413,2012-02-17,Hoffenheim,Mainz,1,1,D,1,1,26,35,23,21,D,D,D,D,L,W,-25,-34,9,2,22
1414,2012-02-18,Freiburg,Bayern Munich,0,0,D,0,0,45,14,18,42,L,W,D,D,L,W,-45,-14,-31,-24,22
1415,2012-02-18,Hamburg,Werder Bremen,1,3,A,1,3,35,35,25,36,W,D,D,D,W,D,-34,-32,-2,-11,22
1416,2012-02-18,Hertha,Dortmund,0,1,A,0,1,35,13,19,49,L,W,L,W,L,W,-35,-12,-23,-30,22
1417,2012-02-18,Kaiserslautern,M'gladbach,1,2,A,1,2,27,12,17,45,L,W,L,D,D,W,-26,-10,-16,-28,22
1418,2012-02-18,Leverkusen,Augsburg,4,1,H,4,1,29,36,31,17,L,D,D,D,D,D,-25,-35,10,14,22
1419,2012-02-18,Nurnberg,FC Koln,2,1,H,2,1,30,38,25,24,D,L,L,W,L,L,-28,-37,9,1,22
1420,2012-02-19,Hannover,Stuttgart,4,2,H,4,2,26,31,31,25,D,W,W,D,W,L,-22,-29,7,6,22
1421,2012-02-19,Schalke 04,Wolfsburg,4,0,H,4,0,27,41,41,27,L,W,D,D,W,L,-23,-41,18,14,22
1422,2012-02-24,M'gladbach,Hamburg,1,1,D,1,1,13,36,46,26,W,L,W,W,D,D,-12,-35,23,20,23
1423,2012-02-25,Augsburg,Hertha,3,0,H,3,0,36,38,20,19,L,L,D,L,D,L,-33,-38,5,1,23
1424,2012-02-25,FC Koln,Leverkusen,0,2,A,0,2,40,29,24,34,L,W,L,L,W,D,-40,-27,-13,-10,23
1425,2012-02-25,Mainz,Kaiserslautern,4,0,H,4,0,35,31,24,17,D,L,D,L,D,L,-31,-31,0,7,23
1426,2012-02-25,Stuttgart,Freiburg,4,1,H,4,1,32,49,28,18,L,D,W,L,D,D,-28,-48,20,10,23
1427,2012-02-25,Werder Bremen,Nurnberg,0,1,A,0,1,36,30,36,28,W,W,D,D,D,L,-36,-29,-7,8,23
1428,2012-02-25,Wolfsburg,Hoffenheim,1,2,A,1,2,43,27,27,26,L,D,W,D,D,D,-42,-25,-17,1,23
1429,2012-02-26,Bayern Munich,Schalke 04,2,0,H,2,0,14,29,45,41,D,W,W,L,D,D,-12,-29,17,4,23
1430,2012-02-26,Dortmund,Hannover,3,1,H,3,1,14,29,52,31,W,W,W,D,W,W,-11,-28,17,21,23
1431,2012-03-03,Dortmund,Mainz,2,1,H,2,1,15,37,55,24,W,W,W,D,W,D,-13,-36,23,31,24
1432,2012-03-03,Freiburg,Schalke 04,2,1,H,2,1,50,31,21,41,L,L,D,W,L,L,-48,-30,-18,-20,24
1433,2012-03-03,Hamburg,Stuttgart,0,4,A,0,4,40,32,26,31,D,W,L,L,W,W,-40,-28,-12,-5,24
1434,2012-03-03,Hannover,Augsburg,2,2,D,2,2,31,38,32,21,L,W,W,L,D,D,-29,-36,7,11,24
1435,2012-03-03,Hertha,Werder Bremen,1,0,H,1,0,38,37,22,36,L,L,L,W,L,D,-37,-37,0,-14,24
1436,2012-03-03,Kaiserslautern,Wolfsburg,0,0,D,0,0,31,43,18,28,L,L,L,L,L,W,-31,-43,12,-10,24
1437,2012-03-03,Leverkusen,Bayern Munich,2,0,H,2,0,29,16,37,45,W,W,W,D,L,W,-27,-16,-11,-8,24
1438,2012-03-04,Hoffenheim,FC Koln,1,1,D,1,1,28,41,27,25,W,L,D,L,D,L,-27,-40,13,2,24
1439,2012-03-04,Nurnberg,M'gladbach,1,0,H,1,0,30,14,31,46,W,D,W,W,D,W,-29,-14,-15,-15,24
1440,2012-03-09,Stuttgart,Kaiserslautern,0,0,D,0,0,32,31,32,19,W,D,W,L,L,L,-32,-31,-1,13,25
1441,2012-03-10,Augsburg,Dortmund,0,0,D,0,0,38,15,22,56,D,W,W,W,L,W,-38,-15,-23,-34,25
1442,2012-03-10,Bayern Munich,Hoffenheim,7,1,H,7,1,17,35,48,27,L,D,W,W,D,D,-10,-34,24,21,25
1443,2012-03-10,FC Koln,Hertha,1,0,H,1,0,41,39,28,22,D,W,L,L,L,L,-40,-39,-1,6,25
1444,2012-03-10,Mainz,Nurnberg,2,1,H,2,1,38,32,27,31,L,W,W,W,D,W,-36,-31,-5,-4,25
1445,2012-03-10,M'gladbach,Freiburg,0,0,D,0,0,14,50,47,22,L,W,D,L,W,D,-14,-50,36,25,25
1446,2012-03-10,Wolfsburg,Leverkusen,3,2,H,3,2,45,32,31,37,D,W,L,W,L,W,-42,-30,-12,-6,25
1447,2012-03-11,Schalke 04,Hamburg,3,1,H,3,1,32,43,44,26,L,L,L,D,W,L,-29,-42,13,18,25
1448,2012-03-11,Werder Bremen,Hannover,3,0,H,3,0,37,34,39,32,L,D,L,L,W,W,-34,-34,0,7,25
1449,2012-03-16,Hoffenheim,Stuttgart,1,2,A,1,2,37,33,27,35,L,D,D,W,W,W,-36,-31,-5,-8,26
1450,2012-03-17,Augsburg,Mainz,2,1,H,2,1,39,40,25,27,D,W,D,L,W,W,-37,-39,2,-2,26
1451,2012-03-17,Dortmund,Werder Bremen,1,0,H,1,0,15,38,59,39,D,W,W,L,W,L,-14,-38,24,20,26
1452,2012-03-17,Hamburg,Freiburg,1,3,A,1,3,46,51,26,25,L,D,L,W,D,L,-45,-48,3,1,26
1453,2012-03-17,Hertha,Bayern Munich,0,6,A,0,6,45,17,22,51,L,W,W,L,L,W,-45,-11,-34,-29,26
1454,2012-03-17,Leverkusen,M'gladbach,1,2,A,1,2,34,15,37,50,L,D,W,L,W,D,-33,-13,-20,-13,26
1455,2012-03-17,Nurnberg,Wolfsburg,1,3,A,1,3,35,46,31,34,L,W,W,D,W,L,-34,-43,9,-3,26
1456,2012-03-18,Hannover,FC Koln,4,1,H,4,1,35,45,35,28,L,W,D,D,L,L,-31,-44,13,7,26
1457,2012-03-18,Kaiserslautern,Schalke 04,1,4,A,1,4,35,33,19,47,D,W,D,L,L,L,-34,-29,-5,-28,26
1458,2012-03-23,Wolfsburg,Hamburg,2,1,H,2,1,47,48,37,26,W,L,W,L,D,L,-45,-47,2,11,27
1459,2012-03-24,Bayern Munich,Hannover,2,1,H,2,1,18,37,54,35,W,W,W,L,L,D,-16,-36,20,19,27
1460,2012-03-24,Freiburg,Kaiserslautern,2,0,H,2,0,51,37,28,19,W,L,D,D,W,D,-49,-37,-12,9,27
1461,2012-03-24,Mainz,Hertha,1,3,A,1,3,43,46,27,25,L,L,W,L,L,W,-42,-43,1,2,27
1462,2012-03-24,M'gladbach,Hoffenheim,1,2,A,1,2,17,38,50,30,W,L,D,L,L,D,-16,-36,20,20,27
1463,2012-03-24,Schalke 04,Leverkusen,2,0,H,2,0,33,36,50,37,W,L,W,L,L,W,-31,-36,5,13,27
1464,2012-03-24,Werder Bremen,Augsburg,1,1,D,1,1,39,40,40,26,L,W,W,D,L,D,-38,-39,1,14,27
1465,2012-03-25,FC Koln,Dortmund,1,6,A,1,6,51,16,28,62,L,W,W,D,D,W,-50,-10,-40,-34,27
1466,2012-03-25,Stuttgart,Nurnberg,1,0,H,1,0,33,36,38,31,W,L,D,L,W,W,-32,-36,4,7,27
1467,2012-03-30,Dortmund,Stuttgart,4,4,D,4,4,20,37,63,39,W,W,W,W,D,D,-16,-33,17,24,28
1468,2012-03-31,Augsburg,FC Koln,2,1,H,2,1,41,53,29,28,D,L,W,L,D,W,-39,-52,13,1,28
1469,2012-03-31,Hertha,Wolfsburg,1,4,A,1,4,50,48,25,40,W,W,L,W,L,W,-49,-44,-5,-15,28
1470,2012-03-31,Kaiserslautern,Hamburg,0,1,A,0,1,38,48,19,29,L,L,L,L,D,L,-38,-47,9,-10,28
1471,2012-03-31,Leverkusen,Freiburg,0,2,A,0,2,38,51,37,31,L,W,L,W,L,D,-38,-49,11,6,28
1472,2012-03-31,Nurnberg,Bayern Munich,0,1,A,0,1,37,18,31,57,L,W,L,W,L,W,-37,-17,-20,-26,28
1473,2012-03-31,Werder Bremen,Mainz,0,3,A,0,3,42,43,40,30,D,L,L,L,W,W,-42,-40,-2,10,28
1474,2012-04-01,Hannover,M'gladbach,2,1,H,2,1,38,19,38,50,L,L,W,W,L,D,-36,-18,-18,-12,28
1475,2012-04-01,Hoffenheim,Schalke 04,1,1,D,1,1,39,34,31,51,W,W,L,W,L,W,-38,-33,-5,-20,28
1476,2012-04-07,Bayern Munich,Augsburg,2,1,H,2,1,19,43,60,29,W,W,W,D,W,W,-17,-42,25,31,29
1477,2012-04-07,FC Koln,Werder Bremen,1,1,D,1,1,54,43,29,41,L,L,L,D,L,L,-53,-42,-11,-12,29
1478,2012-04-07,Freiburg,Nurnberg,2,2,D,2,2,53,39,32,32,W,L,W,L,W,L,-51,-37,-14,0,29
1479,2012-04-07,Kaiserslautern,Hoffenheim,1,2,A,1,2,40,40,19,34,L,D,L,W,L,L,-39,-38,-1,-15,29
1480,2012-04-07,M'gladbach,Hertha,0,0,D,0,0,19,50,51,26,L,L,L,W,W,L,-19,-50,31,25,29
1481,2012-04-07,Stuttgart,Mainz,4,1,H,4,1,38,47,42,30,D,W,W,L,W,L,-34,-46,12,12,29
1482,2012-04-07,Wolfsburg,Dortmund,1,3,A,1,3,51,21,40,66,W,D,W,W,W,W,-50,-18,-32,-26,29
1483,2012-04-08,Hamburg,Leverkusen,1,1,D,1,1,49,39,30,38,W,L,L,L,L,L,-48,-38,-10,-8,29
1484,2012-04-08,Schalke 04,Hannover,3,0,H,3,0,34,41,54,38,D,W,W,L,W,W,-31,-41,10,16,29
1485,2012-04-10,Augsburg,Stuttgart,1,3,A,1,3,46,39,29,45,L,W,W,D,D,W,-45,-36,-9,-16,30
1486,2012-04-10,Hertha,Freiburg,1,2,A,1,2,52,54,26,35,D,D,L,W,W,W,-51,-52,1,-9,30
1487,2012-04-10,Mainz,FC Koln,4,0,H,4,0,47,58,33,29,L,D,W,L,L,L,-43,-58,15,4,30
1488,2012-04-10,Werder Bremen,M'gladbach,2,2,D,2,2,45,21,42,52,D,D,L,L,D,L,-43,-19,-24,-10,30
1489,2012-04-11,Dortmund,Bayern Munich,1,0,H,1,0,21,20,69,60,W,W,D,W,W,W,-20,-20,0,9,30
1490,2012-04-11,Hannover,Wolfsburg,2,0,H,2,0,41,53,41,40,L,L,W,W,L,W,-39,-53,14,1,30
1491,2012-04-11,Hoffenheim,Hamburg,4,0,H,4,0,40,53,37,30,W,D,D,W,W,L,-36,-53,17,7,30
1492,2012-04-11,Leverkusen,Kaiserslautern,3,1,H,3,1,40,43,41,19,D,L,L,L,L,L,-37,-42,5,22,30
1493,2012-04-11,Nurnberg,Schalke 04,4,1,H,4,1,40,38,35,54,D,W,L,D,L,W,-36,-37,1,-19,30
1494,2012-04-13,Stuttgart,Werder Bremen,4,1,H,4,1,40,49,48,42,W,D,W,D,D,L,-36,-48,12,6,31
1495,2012-04-14,Bayern Munich,Mainz,0,0,D,0,0,20,47,61,34,L,W,W,L,W,W,-20,-47,27,27,31
1496,2012-04-14,Hamburg,Hannover,1,0,H,1,0,53,42,33,41,L,W,D,L,W,W,-52,-42,-10,-8,31
1497,2012-04-14,Kaiserslautern,Nurnberg,0,2,A,0,2,45,40,19,38,L,W,L,D,L,L,-45,-38,-7,-19,31
1498,2012-04-14,Leverkusen,Hertha,3,3,D,3,3,43,55,42,27,W,L,D,D,L,L,-40,-52,12,15,31
1499,2012-04-14,Schalke 04,Dortmund,1,2,A,1,2,40,22,54,72,L,W,W,W,D,D,-39,-20,-19,-18,31
1500,2012-04-14,Wolfsburg,Augsburg,1,2,A,1,2,55,47,40,32,L,L,L,L,W,W,-54,-45,-9,8,31
1501,2012-04-15,Freiburg,Hoffenheim,0,0,D,0,0,54,40,36,38,W,W,D,W,W,D,-54,-40,-14,-2,31
1502,2012-04-15,M'gladbach,FC Koln,3,0,H,3,0,21,61,55,29,D,L,D,D,L,L,-18,-61,43,26,31
1503,2012-04-20,Mainz,Wolfsburg,0,0,D,0,0,47,55,35,41,D,L,W,L,L,L,-47,-55,8,-6,32
1504,2012-04-21,Dortmund,M'gladbach,2,0,H,2,0,22,23,75,55,W,W,W,D,W,D,-20,-23,3,20,32
1505,2012-04-21,FC Koln,Stuttgart,1,1,D,1,1,62,41,30,49,L,W,L,W,D,W,-61,-40,-21,-19,32
1506,2012-04-21,Hertha,Kaiserslautern,1,2,A,1,2,57,46,27,22,D,L,L,L,D,L,-56,-44,-12,5,32
1507,2012-04-21,Hoffenheim,Leverkusen,0,1,A,0,1,41,43,38,45,D,D,W,W,W,D,-41,-42,1,-7,32
1508,2012-04-21,Nurnberg,Hamburg,1,1,D,1,1,41,54,39,34,W,W,W,L,D,D,-40,-53,13,5,32
1509,2012-04-21,Werder Bremen,Bayern Munich,1,2,A,1,2,51,21,42,64,L,D,D,L,D,W,-50,-19,-31,-22,32
1510,2012-04-22,Augsburg,Schalke 04,1,1,D,1,1,48,41,33,55,W,L,L,L,L,W,-47,-40,-7,-22,32
1511,2012-04-22,Hannover,Freiburg,0,0,D,0,0,42,54,42,37,L,D,W,W,L,D,-42,-54,12,5,32
1512,2012-04-28,Bayern Munich,Stuttgart,2,0,H,2,0,21,43,67,49,W,D,D,W,L,W,-19,-43,24,18,33
1513,2012-04-28,Freiburg,FC Koln,4,1,H,4,1,55,66,40,30,D,D,D,L,W,L,-51,-65,14,10,33
1514,2012-04-28,Hamburg,Mainz,0,0,D,0,0,54,47,35,36,D,D,W,D,L,W,-54,-47,-7,-1,33
1515,2012-04-28,Hoffenheim,Nurnberg,2,3,A,2,3,44,43,38,42,L,D,D,W,W,W,-42,-40,-2,-4,33
1516,2012-04-28,Kaiserslautern,Dortmund,2,5,A,2,5,51,24,22,78,W,W,L,W,L,W,-49,-19,-30,-56,33
1517,2012-04-28,Leverkusen,Hannover,1,0,H,1,0,43,43,48,42,W,D,D,L,W,W,-42,-43,1,6,33
1518,2012-04-28,M'gladbach,Augsburg,0,0,D,0,0,23,48,56,34,L,D,W,W,D,L,-23,-48,25,22,33
1519,2012-04-28,Schalke 04,Hertha,4,0,H,4,0,41,61,58,27,D,L,L,D,L,L,-37,-61,24,31,33
1520,2012-04-28,Wolfsburg,Werder Bremen,3,1,H,3,1,56,54,44,42,D,L,L,L,L,D,-53,-53,0,2,33
1521,2012-05-05,Augsburg,Hamburg,1,0,H,1,0,48,55,37,35,D,D,D,D,W,W,-47,-55,8,2,34
1522,2012-05-05,Dortmund,Freiburg,4,0,H,4,0,24,59,81,40,W,W,W,D,W,D,-20,-59,39,41,34
1523,2012-05-05,FC Koln,Bayern Munich,1,4,A,1,4,70,22,30,70,L,W,D,W,L,D,-69,-18,-51,-40,34
1524,2012-05-05,Hannover,Kaiserslautern,2,1,H,2,1,44,53,45,22,L,L,D,W,L,L,-42,-52,10,23,34
1525,2012-05-05,Hertha,Hoffenheim,3,1,H,3,1,62,47,30,38,L,L,L,L,D,D,-59,-46,-13,-8,34
1526,2012-05-05,Mainz,M'gladbach,0,3,A,0,3,50,23,36,59,D,D,D,L,D,W,-50,-20,-30,-23,34
1527,2012-05-05,Nurnberg,Leverkusen,1,4,A,1,4,47,44,42,51,W,W,D,W,W,D,-46,-40,-6,-9,34
1528,2012-05-05,Stuttgart,Wolfsburg,3,2,H,3,2,45,59,52,44,L,W,D,D,W,L,-42,-57,15,8,34
1529,2012-05-05,Werder Bremen,Schalke 04,2,3,A,2,3,57,43,42,61,L,W,L,D,L,L,-55,-40,-15,-19,34
